CODMUNI,OBJECTID,NombreCCAA,Provincia,Municipio,MINMDT,MAXMDT,RANGEMDT,MEANMDT,STDMDT,MINPENDI,MAXPENDI,RANGEPENDI,MEANPENDI,STDPENDI,MINDISN10M,MAXDISN10M,RANGEDISN10M,MEANDISN10M,STDDISN10M,MINCARRETN,MAXCARRETN,RANGECARRETN,MEANCARRETN,STDCARRETN,MINDISAUT,MAXDISAUT,RANGEDISAUT,MEANDISAUT,STDDISAUT,MINDISFERR,MAXDISFERR,RANGEDISFERR,MEANDISFERR,STDDISFERR,NAT2000,NAT2001,NAT2002,NAT2003,NAT2004,NAT2005,NAT2006,NAT2007,NAT2008,NAT2009,NAT2010,NAT2011,NAT2012,NAT2013,NAT2014,NAT2015,NAT2016,NAT2017,NAT2018,NAT2019,NAT2020,MOR2000,MOR2001,MOR2002,MOR2003,MOR2004,MOR2005,MOR2006,MOR2007,MOR2008,MOR2009,MOR2010,MOR2011,MOR2012,MOR2013,MOR2014,MOR2015,MOR2016,MOR2017,MOR2018,MOR2019,MOR2020,SVEG2000,SVEG2001,SVEG2002,SVEG2003,SVEG2004,SVEG2005,SVEG2006,SVEG2007,SVEG2008,SVEG2009,SVEG2010,SVEG2011,SVEG2012,SVEG2013,SVEG2014,SVEG2015,SVEG2016,SVEG2017,SVEG2018,SVEG2019,SVEG2020,TBNAT2000,TBNAT2001,TBNAT2002,TBNAT2003,TBNAT2004,TBNAT2005,TBNAT2006,TBNAT2007,TBNAT2008,TBNAT2009,TBNAT2010,TBNAT2011,TBNAT2012,TBNAT2013,TBNAT2014,TBNAT2015,TBNAT2016,TBNAT2017,TBNAT2018,TBNAT2019,TBNAT2020,TBMOR2000,TBMOR2001,TBMOR2002,TBMOR2003,TBMOR2004,TBMOR2005,TBMOR2006,TBMOR2007,TBMOR2008,TBMOR2009,TBMOR2010,TBMOR2011,TBMOR2012,TBMOR2013,TBMOR2014,TBMOR2015,TBMOR2016,TBMOR2017,TBMOR2018,TBMOR2019,TBMOR2020,TCVEG2000,TCVEG2001,TCVEG2002,TCVEG2003,TCVEG2004,TCVEG2005,TCVEG2006,TCVEG2007,TCVEG2008,TCVEG2009,TCVEG2010,TCVEG2011,TCVEG2012,TCVEG2013,TCVEG2014,TCVEG2015,TCVEG2016,TCVEG2017,TCVEG2018,TCVEG2019,TCVEG2020,ALTASTT2012,ALTASINT2012,ALTASEXT2012,BAJASTT2012,BAJASINT2012,BAJASEXT2012,SALDOTT2012,SALDOINT2012,SALDOEXT2012,ALTASTT2013,ALTASINT2013,ALTASEXT2013,BAJASTT2013,BAJASINT2013,BAJASEXT2013,SALDOTT2013,SALDOINT2013,SALDOEXT2013,ALTASTT2014,ALTASINT2014,ALTASEXT2014,BAJASTT2014,BAJASINT2014,BAJASEXT2014,SALDOTT2014,SALDOINT2014,SALDOEXT2014,ALTASTT2015,ALTASINT2015,ALTASEXT2015,BAJASTT2015,BAJASINT2015,BAJASEXT2015,SALDOTT2015,SALDOINT2015,SALDOEXT2015,ALTASTT2016,ALTASINT2016,ALTASEXT2016,BAJASTT2016,BAJASINT2016,BAJASEXT2016,SALDOTT2016,SALDOINT2016,SALDOEXT2016,ALTASTT2017,ALTASINT2017,ALTASEXT2017,BAJASTT2017,BAJASINT2017,BAJASEXT2017,SALDOTT2017,SALDOINT2017,SALDOEXT2017,ALTASTT2018,ALTASINT2018,ALTASEXT2018,BAJASTT2018,BAJASINT2018,BAJASEXT2018,SALDOTT2018,SALDOINT2018,SALDOEXT2018,ALTASTT2019,ALTASINT2019,ALTASEXT2019,BAJASTT2019,BAJASINT2019,BAJASEXT2019,SALDOTT2019,SALDOINT2019,SALDOEXT2019,ALTASTT2020,ALTASINT2020,ALTASEXT2020,BAJASTT2020,BAJASINT2020,BAJASEXT2020,SALDOTT2020,SALDOINT2020,SALDOEXT2020,0A4_21,0A4_10,0A4_03,5A9_21,5A9_10,5A9_03,10A14_21,10A14_10,10A14_03,15A19_21,15A19_10,15A19_03,20A24_21,20A24_10,20A24_03,25A29_21,25A29_10,25A29_03,30A34_21,30A34_10,30A34_03,35A39_21,35A39_10,35A39_03,40A44_21,40A44_10,40A44_03,45A49_21,45A49_10,45A49_03,50A54_21,50A54_10,50A54_03,55A59_21,55A59_10,55A59_03,60A64_21,60A64_10,60A64_03,65A69_21,65A69_10,65A69_03,70A74_21,70A74_10,70A74_03,75A79_21,75A79_10,75A79_03,80A84_21,80A84_10,80A84_03,85A89_21,85A89_10,85A89_03,90A94_21,90A94_10,90A94_03,95A99_21,95A99_10,95A99_03,100YMS_21,100YMS_10,100YMS_03,H0A4_21,H0A4_10,H0A4_03,H5A9_21,H5A9_10,H5A9_03,H10A14_21,H10A14_10,H10A14_03,H15A19_21,H15A19_10,H15A19_03,H20A24_21,H20A24_10,H20A24_03,H25A29_21,H25A29_10,H25A29_03,H30A34_21,H30A34_10,H30A34_03,H35A39_21,H35A39_10,H35A39_03,H40A44_21,H40A44_10,H40A44_03,H45A49_21,H45A49_10,H45A49_03,H50A54_21,H50A54_10,H50A54_03,H55A59_21,H55A59_10,H55A59_03,H60A64_21,H60A64_10,H60A64_03,H65A69_21,H65A69_10,H65A69_03,H70A74_21,H70A74_10,H70A74_03,H75A79_21,H75A79_10,H75A79_03,H80A84_21,H80A84_10,H80A84_03,H85A89_21,H85A89_10,H85A89_03,H90A94_21,H90A94_10,H90A94_03,H95A99_21,H95A99_10,H95A99_03,H100MS_21,H100MS_10,H100MS_03,M0A4_21,M0A4_10,M0A4_03,M5A9_21,M5A9_10,M5A9_03,M10A14_21,M10A14_10,M10A14_03,M15A19_21,M15A19_10,M15A19_03,M20A24_21,M20A24_10,M20A24_03,M25A29_21,M25A29_10,M25A29_03,M30A34_21,M30A34_10,M30A34_03,M35A39_21,M35A39_10,M35A39_03,M40A44_21,M40A44_10,M40A44_03,M45A49_21,M45A49_10,M45A49_03,M50A54_21,M50A54_10,M50A54_03,M55A59_21,M55A59_10,M55A59_03,M60A64_21,M60A64_10,M60A64_03,M65A69_21,M65A69_10,M65A69_03,M70A74_21,M70A74_10,M70A74_03,M75A79_21,M75A79_10,M75A79_03,M80A84_21,M80A84_10,M80A84_03,M85A89_21,M85A89_10,M85A89_03,M90A94_21,M90A94_10,M90A94_03,M95A99_21,M95A99_10,M95A99_03,M100YMS_21,M100YMS_10,M100YMS_03,TJUVEN03,TJUVEN10,TJUVEN21,MPVIE03,MPJOV03,MPVIE10,MPJOV10,MPVIE21,MPJOV21,HPVIE03,HPJOV03,HPVIE10,HPJOV10,HPVIE21,HPJOV21,PJOV10,PJOV21,PVIEJ03,PVIEJ10,PVIEJ21,TENVEJ03,TENVEJ10,TENVEJ21,RMASCU03,RMASCU10,RMASCU21,PADUL03,PADUL10,PADUL21,PRPAD03,PRPAD10,PRPAD21,DEPEND03,DEPEND10,DEPEND21,IDV2003,IDV2010,IDV2021,IENVEJ03,IENVEJ10,IENVEJ21,PSOP03,PRPSO03,PRPSO10,PSOP10,PRPSO21,PSOP21,IREEMP03,IREEMP10,IREEMP21,PRMEF03,MEFEC03,HIJMUJ03,PRMEF10,MEFEC10,HIJMUJ10,PRMEF21,MEFEC21,HIJMUJ21,CARMAT03,CARMAT10,CARMAT21,Shape_Length,Shape_Area,POB2021,POB2020,POB2019,POB2018,POB2017,POB2016,POB2015,POB2014,POB2013,POB2012,POB2011,POB2010,POB2009,POB2008,POB2007,POB2006,POB2005,POB2004,POB2003,POB2002,POB2001,POB2000,POB1999,POB1998,POB1997,POB1996,POB1991,POB1981,POB1970,POB1960,POB1950,POB1940,POB1930,POB1920,POB1910,POB1900,AREAKM2,DEN1900,DEN1910,DEN1920,DEN1930,DEN1940,DEN1950,DEN1960,DEN1970,DEN1981,DEN1991,DEN1996,DEN1997,DEN1998,DEN1999,DEN2000,DEN2001,DEN2002,DEN2003,DEN2004,DEN2005,DEN2006,DEN2007,DEN2008,DEN2009,DEN2010,DEN2011,DEN2012,DEN2013,DEN2014,DEN2015,DEN2016,DEN2017,DEN2018,DEN2019,DEN2020,DEN2021,NHOSPI,NFARMA,NCENTEDUC,NATURGHOSP,NATPRIMARIA,DISTHOSPIT,DISTFARMA,DISTCEDUC,DISTCURGH,DISTATPRIM,VIVTUR21,PLA21,KM2BLAN,KM2GRIS,CBMAS30,CBMAS100,COB3G,COB4G
39084,2377,Cantabria,Cantabria,Sol√≥rzano,65,552,487,220.69055299999997,104.095285,0.0,31.196602000000002,31.196602000000002,11.105984,6.565275,10222.36131,18030.0433,7807.681992,14238.81231,1774.444489,2309.794799,7925.652934999999,5615.858136,5211.558900999999,1368.464182,2536.012162,7879.639097,5343.626935,5252.1176780000005,1356.1342710000001,2705.68166,8746.590231999999,6040.908573,5749.752886,1469.249092,3.0,4.0,6.0,8.0,7.0,6.0,11,7,7,9,4,12,9,3,5,13,12,3,4,7,7,11.0,10.0,13.0,23.0,11.0,9.0,12,22,10,14,8,8,14,11,14,17,6,10,12,8,12,-8,-6,-7,-15,-4,-3,-1,-15,-3,-5,-4,4,-5,-8,-9,-4,6,-7,-8,-1,-5,3.558718861,4.79616307,7.290400972,9.696969697,8.45410628,7.237635706,13.04863582,8.333333332999999,8.206330598,10.52631579,4.602991945,13.77726751,10.56338028,3.436426117,5.649717514,14.52513966,13.28903654,3.3222591360000004,4.324324324,7.494646681,3.2327586210000003,13.04863582,11.99040767,15.79586877,27.87878788,13.28502415,10.85645356,14.23487544,26.19047619,11.72332943,16.37426901,9.20598389,9.184845006,16.43192488,12.6002291,15.81920904,18.99441341,6.644518272000001,11.07419712,12.97297297,8.565310493,12.93103448,-9.489916963,-7.194244604,-8.505467801,-18.18181818,-4.830917874,-3.618817853,-1.18623962,-17.85714286,-3.516998828,-5.8479532160000005,-4.602991945,4.592422503,-5.868544601,-9.163802978,-10.16949153,-4.4692737430000005,6.644518272000001,-7.751937984,-8.648648649,-1.070663812,-5.387931034,48,45,3,35,33,2,13,12,1,31,28,3,50,48,2,-19,-20,1,63,60,3,45,43,2,18,17,1,60,57,3,53,53,0,7,4,3,60,52,8,41,40,1,19,12,7,53,51,2,34,32,2,19,19,0,65,54,11,54,52,2,11,2,9,60,46,14,54,53,1,6,-7,13,67,64,3,69,60,9,-2,4,-6,29.0,42.0,26.0,44.0,35.0,37.0,43.0,39.0,33.0,38.0,35.0,52.0,38.0,48.0,70.0,53.0,66.0,96.0,43.0,98.0,55.0,66.0,77.0,79.0,86.0,82.0,63.0,89.0,75.0,75.0,76.0,89.0,67.0,101.0,68.0,61.0,80.0,60.0,52.0,71.0,57.0,62.0,49.0,54.0,77.0,54.0,59.0,53.0,32.0,42.0,37.0,33.0,21.0,25.0,21.0,7.0,8.0,2.0,1.0,0.0,0.0,0.0,0.0,16.0,17.0,16.0,25.0,19.0,15.0,22.0,17.0,17.0,22.0,18.0,24.0,21.0,32.0,44.0,23.0,34.0,48.0,27.0,59.0,33.0,33.0,42.0,42.0,47.0,38.0,35.0,49.0,49.0,41.0,38.0,49.0,30.0,58.0,29.0,34.0,45.0,31.0,28.0,31.0,29.0,34.0,25.0,35.0,41.0,29.0,27.0,28.0,21.0,21.0,16.0,19.0,11.0,10.0,4.0,2.0,3.0,1.0,0.0,0.0,0.0,0.0,0.0,13.0,25.0,10.0,19.0,16.0,22.0,21.0,22.0,16.0,16.0,17.0,28.0,17.0,16.0,26.0,30.0,32.0,48.0,16.0,39.0,22.0,33.0,35.0,37.0,39.0,44.0,28.0,40.0,26.0,34.0,38.0,40.0,37.0,43.0,39.0,27.0,35.0,29.0,24.0,40.0,28.0,28.0,24.0,19.0,36.0,25.0,32.0,25.0,11.0,21.0,21.0,14.0,10.0,15.0,17.0,5.0,5.0,1.0,1.0,0.0,0.0,0.0,0.0,9.338521401,10.99526066,11.06870229,130,48,116,63,132,53,132,48,116,53,132,63,116,116,262,241,262,25.48638132,22.843601899999996,25.0,110.2249489,112.7016129,113.0081301,670,698,670,65.17509728,66.16113744,63.93129771,135.1044776,150.5272206,155.1044776,39.10447761,34.52722063,39.10447761,272.9166667,207.7586207,225.862069,15031,1462.159533,31.46919431,332,27.09923664,284,100.0,171.4285714,210.52631580000002,46.21676892,226,11.50442478,81.85483871,406,10.34482759,35.16260163,173,16.76300578,4.424778761000001,6.157635468,7.514450867000001,21861.968080000002,25429618.19,1048.0,1046.0,1047.0,1050.0,1040.0,1012.0,1010.0,1002.0,1030.0,1025.0,1056.0,1055.0,1053.0,1063.0,1067.0,1052.0,1053.0,1056.0,1028.0,1000.0,987.0,995.0,1003.0,1003.0,1008.5,1014.0,1022.0,1094.0,1144.0,1293.0,1463.0,1420.0,1279.0,1284.0,1147.0,1079.0,25.42961884,42.43083654,45.10488370000001,50.49230224,50.29568112,55.84039655,57.53133814,50.84622024,44.98691103,43.02069988,40.18935583,39.87476205,39.65847882,39.44219559,39.44219559,39.12760181,38.81300803,39.32422293,40.42530117,41.52637941,41.40840674,41.36908252,41.95894586,41.80164897,41.40840674,41.48705519,41.52637941,40.3073285,40.50394961,39.40287137,39.71746515,39.7961136,40.89719184,41.29043407,41.1724614,41.13313718,41.21178563,0,1,0,0,2,13305.256790000001,6689.805575,5668.360818,8655.201148,1503.589655,9,79,0.020987807999999997,0,0.6,0.0,0.98,0.98
39085,2378,Cantabria,Cantabria,Suances,-6,218,224,57.649513,42.324675,0.0,23.273787,23.273787,5.522714,4.048844,3627.1609810000004,10322.17115,6695.010172,7050.115589,1466.34042,630.787888,7233.621663,6602.833775,3823.505434,1603.0775390000001,711.327573,7398.792064,6687.464491,3933.699944,1619.715707,136.496047,6928.360484999999,6791.864438,3588.079635,1582.686909,47.0,63.0,68.0,63.0,65.0,70.0,98,77,101,81,82,77,86,67,77,74,91,64,63,70,44,64.0,41.0,58.0,63.0,71.0,74.0,59,66,59,69,61,69,59,54,62,74,79,76,85,63,66,-17,22,10,0,-6,-4,39,11,42,12,21,8,27,13,15,0,12,-12,-22,7,-22,18.49665486,24.95049505,27.16739912,25.70379437,26.97095436,28.80658436,40.596520299999995,32.57191201,42.96044236,35.12575889,35.43647364,33.10404127,37.11696159,28.966709899999998,33.49282297,32.04850585,41.02795311,28.85482417,28.75399361,32.08065995,21.86046512,25.18693428,16.23762376,23.17219337,25.70379437,29.46058091,30.4526749,24.44076222,27.91878173,25.09570396,29.92194276,26.36127917,29.66466036,25.46396202,23.3463035,26.96824706,32.04850585,34.77112676,34.265103700000004,38.79507074,28.87259395,30.69767442,-6.690279418,8.712871287,3.995205753,0,-2.489626556,-1.646090535,16.15575808,4.653130288,17.86473841,5.203816132,9.075194468,3.439380911,11.65299957,5.620406399,6.524575903,0.0,5.281690141,-5.4102795310000005,-10.04107713,3.208065995,-10.23255814,359,324,35,272,252,20,87,72,15,329,308,21,312,267,45,17,41,-24,321,286,35,297,286,11,24,0,24,318,299,19,308,278,30,10,21,-11,381,335,46,309,296,13,72,39,33,370,329,41,284,268,16,86,61,25,403,367,36,307,291,16,96,76,20,380,346,34,338,325,13,42,21,21,536,496,40,328,315,13,208,181,27,371.0,480.0,290.0,426.0,365.0,275.0,494.0,353.0,271.0,442.0,310.0,364.0,374.0,437.0,533.0,349.0,591.0,564.0,433.0,772.0,617.0,631.0,791.0,583.0,843.0,714.0,564.0,829.0,623.0,481.0,750.0,617.0,417.0,640.0,493.0,380.0,649.0,460.0,309.0,522.0,381.0,345.0,422.0,285.0,351.0,351.0,322.0,246.0,221.0,215.0,133.0,174.0,116.0,76.0,84.0,33.0,28.0,19.0,6.0,9.0,2.0,1.0,2.0,190.0,262.0,144.0,202.0,184.0,163.0,248.0,200.0,143.0,234.0,173.0,191.0,205.0,228.0,263.0,185.0,285.0,271.0,226.0,392.0,326.0,288.0,408.0,287.0,430.0,346.0,273.0,427.0,309.0,247.0,378.0,307.0,220.0,325.0,251.0,187.0,303.0,229.0,146.0,254.0,183.0,167.0,203.0,131.0,153.0,166.0,136.0,117.0,97.0,87.0,53.0,64.0,44.0,22.0,21.0,7.0,6.0,3.0,0.0,2.0,0.0,0.0,0.0,181.0,218.0,146.0,224.0,181.0,112.0,246.0,153.0,128.0,208.0,137.0,173.0,169.0,209.0,270.0,164.0,306.0,293.0,207.0,380.0,291.0,343.0,383.0,296.0,413.0,368.0,291.0,402.0,314.0,234.0,372.0,310.0,197.0,315.0,242.0,193.0,346.0,231.0,163.0,268.0,198.0,178.0,219.0,154.0,198.0,185.0,186.0,129.0,124.0,128.0,80.0,110.0,72.0,54.0,63.0,26.0,22.0,16.0,6.0,7.0,2.0,1.0,2.0,12.22579702,14.321578,14.30312431,670,386,771,552,987,651,520,450,771,646,987,640,1198,1291,1190,1359,1795,17.40274934,16.2462642,19.88699313,97.80156205,99.02450631,97.20340835,4812,5808,5940,70.37145364,69.4321578,65.80988256,860.7298421,1221.39876,1321.218855,24.72984206,23.39876033,30.21885522,142.3444976,113.43906509999998,139.0395043,678,9.915179877,34.66826061,2900,30.31243076,2736,84.89010989,148.38709680000002,146.8325792,46.60109922,1611,18.00124146,86.00999286,3615,13.278008300000002,34.25824776,1568,23.66071429,9.062693979,6.030428768999999,11.54336735,24863.96655,24582482.05,9026.0,8827.0,8782.0,8716.0,8645.0,8579.0,8612.0,8580.0,8552.0,8451.0,8489.0,8365.0,8229.0,7998.0,7707.0,7393.0,7117.0,6906.0,6838.0,6649.0,6529.0,6456.0,6331.0,6237.0,6177.0,6117.0,5842.0,5473.0,5053.0,4846.0,4123.0,3592.0,3215.0,2604.0,2150.0,1798.0,24.58248138,73.14151781,87.46065812,105.92909479999999,130.78419340000002,146.1203181,167.7210667,197.13225549999999,205.5528863,222.6382241,237.64891380000003,248.83574219999997,251.27650469999998,253.7172673,257.5411286,262.6260506,265.595645,270.4771701,278.1655722,280.93176969999996,289.51511810000005,300.7426258,313.5159498,325.3536482,334.750584,340.28297910000003,345.3272217,343.7814055,347.8900224,349.0290449,350.330785,348.98836560000007,351.6732044,354.5614401,357.2462789,359.0768508,367.1720466,0,2,4,1,1,6086.627482,3558.752869,2176.339811,2249.691385,1682.2957350000001,156,814,0.000102619,0,0.99,0.62,1.0,1.0
39001,2379,Cantabria,Cantabria,Alfoz de Lloredo,-3,391,394,141.15611299999998,83.474135,0.122584,33.228851,33.106266999999995,8.968757,5.108402,7426.209531999999,17766.18496,10339.97543,11560.1422,2042.1049679999999,642.0840450000001,7607.870873000001,6965.786828,4448.946061,1613.155484,1505.328834,8355.393331000001,6850.064497,5093.819928,1591.279749,29.899407,6952.335190000001,6922.435783,3612.6493490000003,1563.328365,13.0,15.0,21.0,15.0,10.0,16.0,16,18,15,16,22,16,17,12,12,14,11,10,15,8,11,27.0,19.0,23.0,26.0,33.0,36.0,35,37,29,29,23,27,18,32,29,29,30,31,36,36,35,-14,-4,-2,-11,-23,-20,-19,-19,-14,-13,-1,-11,-1,-20,-17,-15,-19,-21,-21,-28,-24,86.09271523,102.739726,148.9361702,114.5038168,76.92307692,120.3007519,125.984252,152.5423729,136.36363640000002,148.1481481,205.60747659999998,156.86274509999998,165.04854369999998,114.2857143,113.20754720000001,140.0,104.7619048,95.23809524,142.8571429,77.66990291,134.0206186,178.807947,130.1369863,163.1205674,198.4732824,253.8461538,270.6766917,275.5905512,313.559322,263.6363636,268.5185185,214.953271,264.7058824,174.7572816,304.76190479999997,273.5849057,290.0,294.11764710000006,295.23809520000003,342.85714289999993,349.51456310000003,360.82474229999997,-92.71523179,-27.39726027,-14.18439716,-83.96946565,-176.9230769,-150.3759398,-149.6062992,-161.0169492,-127.2727273,-120.37037040000001,-9.345794393,-107.8431373,-9.708737864,-190.4761905,-160.37735849999999,-150.0,-186.27450980000003,-200.0,-200.0,-271.8446602,-247.4226804,83,79,4,68,66,2,15,13,2,54,51,3,67,62,5,-13,-11,-2,81,76,5,76,72,4,5,4,1,76,70,6,78,74,4,-2,-4,2,79,75,4,74,71,3,5,4,1,83,77,6,101,97,4,-18,-20,2,129,116,13,103,101,2,26,15,11,100,91,9,99,96,3,1,-5,6,154,146,8,86,85,1,68,61,7,54.0,80.0,84.0,73.0,76.0,83.0,114.0,96.0,122.0,93.0,102.0,117.0,98.0,114.0,171.0,84.0,142.0,185.0,118.0,180.0,163.0,132.0,158.0,203.0,191.0,166.0,215.0,196.0,216.0,170.0,180.0,198.0,180.0,231.0,188.0,163.0,205.0,182.0,105.0,191.0,119.0,175.0,161.0,135.0,157.0,103.0,151.0,123.0,100.0,98.0,104.0,71.0,60.0,37.0,33.0,29.0,22.0,7.0,3.0,3.0,2.0,0.0,1.0,33.0,48.0,45.0,37.0,36.0,49.0,69.0,50.0,68.0,48.0,61.0,65.0,46.0,56.0,98.0,55.0,72.0,88.0,63.0,101.0,104.0,70.0,86.0,99.0,103.0,84.0,116.0,97.0,115.0,82.0,95.0,99.0,97.0,127.0,100.0,87.0,96.0,96.0,53.0,99.0,54.0,90.0,90.0,68.0,77.0,44.0,69.0,55.0,50.0,44.0,35.0,31.0,12.0,10.0,7.0,8.0,4.0,2.0,1.0,0.0,1.0,0.0,0.0,21.0,32.0,39.0,36.0,40.0,34.0,45.0,46.0,54.0,45.0,41.0,52.0,52.0,58.0,73.0,29.0,70.0,97.0,55.0,79.0,59.0,62.0,72.0,104.0,88.0,82.0,99.0,99.0,101.0,88.0,85.0,99.0,83.0,104.0,88.0,76.0,109.0,86.0,52.0,92.0,65.0,85.0,71.0,67.0,80.0,59.0,82.0,68.0,50.0,54.0,69.0,40.0,48.0,27.0,26.0,21.0,18.0,5.0,2.0,3.0,1.0,0.0,1.0,11.18854046,10.10830325,9.889208043,351,127,339,118,344,102,271,162,339,134,344,139,252,241,622,595,668,24.08052652,23.86682712,27.41075092,104.8374306,102.18978100000001,107.5809199,1672,1646,1528,64.73093302,66.02486963,62.70004103,326.2009569,288.1482382,284.71727749999997,37.20095694,36.14823815,43.71727749,215.22491349999999,236.11111110000002,277.1784232,1934,74.87417731,28.88086643,720,26.13869512,637,89.74358974,178.4313725,220.43010750000002,45.20222046,570,14.73684211,69.9107867,862,9.280742458999999,32.79386712,385,14.02597403,6.842105263,3.712296984,5.454545455,37853.181260000005,46802069.06,2437.0,2394.0,2416.0,2408.0,2446.0,2466.0,2485.0,2499.0,2530.0,2514.0,2484.0,2493.0,2496.0,2502.0,2529.0,2560.0,2600.0,2590.0,2583.0,2593.0,2590.0,2614.0,2608.0,2608.0,2627.0,2646.0,2778.0,2919.0,2949.0,3146.0,3182.0,2990.0,3149.0,2900.0,2855.0,2544.0,46.80207062,54.35656941,61.00157455,61.96307047,67.28334790000001,63.88606232,67.98844491,67.21924818,63.010032700000004,62.36903542,59.356348200000006,56.53596016,56.12999522,55.72403027,55.72403027,55.85222973,55.33943191,55.40353163,55.18986587,55.33943191,55.55309767,54.69843463,54.03607077,53.45917322,53.33097376,53.26687403,53.07457485,53.71557213,54.05743734,53.39507349,53.09594142,52.68997648,52.26264496,51.45071507,51.62164768,51.151583,52.07034577,0,0,2,0,3,9033.361309,4085.905018,3370.399142,7292.33908,1657.810817,64,322,0.00496045,0,0.96,0.0,1.0,1.0
39003,2380,Cantabria,Cantabria,Anievas,203,942,739,467.78432000000004,140.75588100000002,0.17336,37.476574,37.303214000000004,14.057126,5.779102,12638.33971,18888.82245,6250.482731,15944.488640000001,1606.704112,2064.8978469999997,5128.114337,3063.21649,3901.402279,686.708266,2976.319976,7164.904103,4188.584128,5300.48035,1047.948744,1981.811338,6228.468557,4246.657218,4319.904522,1062.857064,0.0,0.0,2.0,2.0,1.0,1.0,2,1,0,3,1,1,0,1,0,2,0,3,1,1,1,4.0,4.0,4.0,4.0,6.0,8.0,2,2,0,7,7,4,6,4,5,5,8,6,4,2,2,-4,-4,-2,-2,-5,-7,0,-1,0,-4,-6,-3,-6,-3,-5,-3,-8,-3,-3,-1,-1,0,0,4.273504274,4.385964912,2.222222222,2.257336343,4.672897196,2.314814815,0.0,6.880733945,2.415458937,2.083333333,0.0,2.369668246,0.0,4.830917874,0.0,7.712082262000001,2.597402597,2.7100271,0.0,8.333333333,8.333333333,8.547008547,8.771929825,13.33333333,18.05869074,4.672897196,4.62962963,0.0,16.05504587,16.90821256,8.333333332999999,13.48314607,9.478672986,12.59445844,12.07729469,19.75308642,15.42416452,10.38961039,5.420054201,5.66572238,-8.333333333,-8.333333333,-4.273504274,-4.385964912,-11.11111111,-15.8013544,0.0,-2.314814815,0.0,-9.174311927,-14.49275362,-6.25,-13.48314607,-7.1090047389999995,-12.59445844,-7.246376812,-19.75308642,-7.712082262000001,-7.792207792,-2.7100271,-2.83286119,7,7,0,11,11,0,-4,-4,0,7,7,0,9,9,0,-2,-2,0,13,13,0,10,10,0,3,3,0,3,3,0,11,11,0,-8,-8,0,4,4,0,22,22,0,-18,-18,0,3,3,0,13,13,0,-10,-10,0,6,6,0,14,14,0,-8,-8,0,13,13,0,9,9,0,4,4,0,4,4,0,10,10,0,-6,-6,0,5.0,7.0,9.0,5.0,6.0,8.0,6.0,10.0,17.0,5.0,14.0,19.0,5.0,19.0,22.0,9.0,24.0,23.0,14.0,17.0,22.0,16.0,19.0,32.0,11.0,28.0,25.0,22.0,26.0,25.0,21.0,29.0,28.0,27.0,27.0,24.0,29.0,23.0,23.0,19.0,22.0,30.0,22.0,28.0,24.0,16.0,22.0,28.0,10.0,23.0,14.0,14.0,13.0,11.0,10.0,5.0,2.0,0.0,1.0,2.0,0.0,0.0,0.0,1.0,4.0,7.0,5.0,2.0,3.0,3.0,7.0,9.0,3.0,9.0,8.0,4.0,10.0,16.0,3.0,14.0,11.0,10.0,4.0,11.0,10.0,13.0,18.0,3.0,12.0,10.0,15.0,13.0,14.0,11.0,11.0,19.0,16.0,18.0,13.0,13.0,11.0,8.0,14.0,10.0,15.0,12.0,13.0,11.0,8.0,10.0,10.0,5.0,13.0,7.0,6.0,3.0,2.0,4.0,1.0,2.0,0.0,0.0,1.0,0.0,0.0,0.0,4.0,3.0,2.0,0.0,4.0,5.0,3.0,3.0,8.0,2.0,5.0,11.0,1.0,9.0,6.0,6.0,10.0,12.0,4.0,13.0,11.0,6.0,6.0,14.0,8.0,16.0,15.0,7.0,13.0,11.0,10.0,18.0,9.0,11.0,9.0,11.0,16.0,12.0,15.0,5.0,12.0,15.0,10.0,15.0,13.0,8.0,12.0,18.0,5.0,10.0,7.0,8.0,10.0,9.0,6.0,4.0,0.0,0.0,1.0,1.0,0.0,0.0,0.0,8.762886598,6.336088154,6.015037594,63,15,64,10,42,7,48,19,64,13,42,9,23,16,111,114,91,28.60824742,31.40495868,34.21052632,101.0362694,96.21621622,121.66666670000001,243,226,159,62.62886598,62.25895317,59.77443609,79.67901235,73.44247788,73.23270440000002,45.67901235,50.44247788,57.2327044,326.47058819999995,495.6521739,568.75,606,156.185567,24.79338843,90,23.68421053,63,121.05263159999998,164.28571430000002,580.0,38.34196891,74,12.16216216,65.40540541,121,5.7851239670000005,27.5,33,15.15151515,2.702702703,2.4793388430000003,12.12121212,18095.006709999998,20968511.21,266.0,274.0,267.0,279.0,291.0,314.0,326.0,327.0,333.0,351.0,363.0,363.0,366.0,361.0,360.0,376.0,381.0,394.0,388.0,378.0,375.0,381.0,398.0,394.0,400.5,407.0,407.0,499.0,603.0,634.0,663.0,716.0,622.0,705.0,722.0,661.0,20.96851158,31.52345828,34.43258226,33.62184279,29.66352655,34.14643892,31.61883939,30.23581324,28.75740596,23.79758802,19.41005676,19.41005676,19.10006814,18.79007952,18.98084175,18.17010228,17.88395893,18.0270306,18.50393618,18.79007952,18.17010228,17.93164949,17.16860058,17.21629113,17.45474392,17.31167225,17.31167225,16.73938556,15.88095553,15.59481219,15.54712163,14.97483495,13.87795213,13.30566545,12.73337876,13.06721266,12.6856882,0,0,0,0,1,18892.14952,9992.467164,7375.229388,6239.139244,1794.658987,5,33,0.025491455,0,0.0,0.0,1.0,1.0
39100,2381,Cantabria,Cantabria,Villafufre,112,828,716,329.966152,142.75193000000002,0.122584,36.627811,36.505227000000005,12.574647,6.543079,11811.46806,17908.87573,6097.407663,15118.0062,1392.512381,1855.8663210000002,8209.010547,6353.144227000001,4637.502394,1354.030563,3017.3955960000003,8966.576362,5949.1807659999995,5651.981909,1432.076543,7856.948181999999,14249.65316,6392.704977,11335.25418,1545.857008,5.0,15.0,12.0,9.0,10.0,7.0,9,11,5,9,7,6,5,3,6,3,12,9,8,2,8,13.0,5.0,19.0,10.0,10.0,14.0,7,14,13,13,10,14,11,7,14,11,14,18,14,15,11,-8,10,-7,-1,0,-7,2,-3,-8,-4,-3,-8,-6,-4,-8,-8,-2,-9,-6,-13,-3,4.541326067,13.68613139,10.84990958,8.211678832,8.873114463,6.311992786,8.272058824,10.0,4.4923629830000005,8.372093023,6.666666667,5.72519084,4.859086492,3.0,5.994005994,2.976190476,12.37113402,9.278350515,8.456659619,2.1367521369999998,5.3763440860000005,11.80744777,4.562043796,17.17902351,9.124087591,8.873114463,12.62398557,6.433823529,12.72727273,11.68014376,12.09302326,9.523809523999999,13.35877863,10.68999028,7.0,13.98601399,10.91269841,14.32958035,18.55670103,14.79915433,16.02564103,11.82795699,-7.266121708,9.124087591,-6.329113924,-0.912408759,0,-6.311992786,1.838235294,-2.727272727,-7.187780772999999,-3.7209302330000003,-2.857142857,-7.6335877860000005,-5.83090379,-4.0,-7.9920079920000004,-7.936507937000001,-2.047082907,-9.278350515,-6.342494715,-13.88888889,-3.225806452,39,38,1,51,49,2,-12,-11,-1,33,32,1,41,41,0,-8,-9,1,29,28,1,45,45,0,-16,-17,1,49,40,9,56,48,8,-7,-8,1,42,37,5,43,39,4,-1,-2,1,54,47,7,35,35,0,19,12,7,32,31,1,45,45,0,-13,-14,1,56,52,4,54,50,4,2,2,0,53,46,7,38,37,1,15,9,6,42.0,44.0,39.0,28.0,48.0,36.0,37.0,45.0,71.0,53.0,51.0,82.0,33.0,73.0,71.0,32.0,63.0,91.0,63.0,80.0,93.0,55.0,93.0,84.0,83.0,90.0,89.0,86.0,96.0,69.0,92.0,73.0,59.0,87.0,78.0,51.0,63.0,47.0,56.0,65.0,61.0,71.0,51.0,57.0,77.0,52.0,67.0,45.0,38.0,45.0,27.0,36.0,21.0,15.0,12.0,5.0,5.0,3.0,2.0,1.0,1.0,1.0,0.0,19.0,24.0,24.0,10.0,24.0,21.0,24.0,30.0,38.0,27.0,22.0,40.0,21.0,33.0,38.0,20.0,36.0,51.0,30.0,41.0,49.0,30.0,54.0,40.0,42.0,44.0,55.0,47.0,49.0,36.0,50.0,47.0,35.0,38.0,38.0,23.0,42.0,24.0,30.0,31.0,32.0,35.0,28.0,32.0,39.0,30.0,30.0,20.0,15.0,19.0,11.0,13.0,8.0,2.0,8.0,0.0,2.0,1.0,1.0,0.0,0.0,0.0,0.0,23.0,20.0,15.0,18.0,24.0,15.0,13.0,15.0,33.0,26.0,29.0,42.0,12.0,40.0,33.0,12.0,27.0,40.0,33.0,39.0,44.0,25.0,39.0,44.0,41.0,46.0,34.0,39.0,47.0,33.0,42.0,26.0,24.0,49.0,40.0,28.0,21.0,23.0,26.0,34.0,29.0,36.0,23.0,25.0,38.0,22.0,37.0,25.0,23.0,26.0,16.0,23.0,13.0,13.0,4.0,5.0,3.0,2.0,1.0,1.0,1.0,1.0,0.0,12.8975265,12.01754386,10.57312253,132,63,137,59,132,54,109,83,137,78,132,53,137,107,241,259,258,21.28975265,22.71929825,25.49407115,108.47145490000001,106.52173909999998,108.2304527,745,744,647,65.81272085,65.26315789,63.93280632,178.34899330000002,171.811828,146.8763524,32.34899329,34.81182796,39.876352399999995,165.06849319999998,189.0510949,241.12149530000002,148,13.07420495,31.49122807,359,28.35968379,287,68.29268293,92.15686275,118.86792450000002,50.27624309,273,14.28571429,81.52173913,450,9.777777777999999,34.97942387,170,24.70588235,5.494505495,4.444444444,13.52941176,23378.85926,30035887.07,1012.0,994.0,1003.0,1029.0,1014.0,1017.0,1032.0,1062.0,1083.0,1103.0,1124.0,1140.0,1109.0,1091.0,1091.0,1078.0,1115.0,1120.0,1132.0,1149.0,1155.0,1145.0,1121.0,1116.0,1111.5,1107.0,1092.0,1264.0,1439.0,1585.0,1675.0,1648.0,1513.0,1519.0,1495.0,1518.0,30.03588676,50.53954331,49.77379265,50.57283682,50.37307578,54.86769919,55.76662388,52.77020827,47.90935627,42.08299259,36.35650942,36.85591202,37.0057328,37.15555358,37.32202111,38.12106528,38.45400034,38.254239299999995,37.68824969,37.28872761,37.12226007,35.89040032,36.32321591,36.32321591,36.92249903,37.95459774,37.42190163,36.72273799,36.05686786,35.35770421,34.35889901,33.85949641,33.75961589,34.25901849,33.39338731,33.09374575,33.69302887,0,0,0,0,1,18897.89015,5427.973068,4586.777634,6234.089421,2070.778547,3,10,0.024886946,0,0.98,0.02,1.0,1.0
39090,2382,Cantabria,Cantabria,Ud√≠as,93,406,313,208.388603,59.292864,0.245168,25.827484,25.582316,9.556939,4.765916000000001,13821.1559,20377.30524,6556.149334000001,16764.10692,1564.2108119999998,681.515184,5005.494757,4323.979573,2791.1776440000003,993.6336369999999,24.123004,4693.156596,4669.033592,2249.6484149999997,1073.912891,1156.337951,5600.159683,4443.821731,3376.075789,962.969078,6.0,4.0,4.0,3.0,7.0,11.0,4,7,7,11,8,10,9,9,7,9,5,8,11,2,8,8.0,18.0,8.0,4.0,10.0,1.0,10,10,4,8,11,9,3,4,7,13,6,8,9,5,14,-2,-14,-4,-1,-3,10,-6,-3,3,3,-3,1,6,5,0,-4,-1,0,2,-3,-6,9.448818898,6.451612903,6.688963211,5.347593583,12.30228471,19.71326165,7.31261426,12.82051282,13.15789474,20.95238095,15.47388781,19.41747573,17.24137931,17.78656126,13.80670611,18.07228916,10.59322034,16.94915254,23.40425532,4.424778761000001,13.27433628,12.5984252,29.03225806,13.37792642,7.130124777,17.57469244,1.792114695,18.28153565,18.31501832,7.518796992,15.23809524,21.27659574,17.47572816,5.747126437,7.90513834,13.80670611,26.10441767,12.5,16.94915254,19.14893617,11.0619469,30.97345133,-3.149606299,-22.58064516,-6.688963211,-1.782531194,-5.272407733,17.92114695,-10.96892139,-5.494505495,5.639097744,5.714285714,-5.80270793,1.9417475730000002,11.49425287,9.881422925,0.0,-8.032128514,-2.083333333,0.0,4.255319149,-6.637168142,-13.27433628,47,45,2,29,29,0,18,16,2,55,53,2,44,38,6,11,15,-4,58,55,3,48,47,1,10,8,2,37,37,0,27,27,0,10,10,0,36,35,1,31,31,0,5,4,1,60,60,0,40,39,1,20,21,-1,50,47,3,44,42,2,6,5,1,40,40,0,44,44,0,-4,-4,0,55,46,9,46,45,1,9,1,8,38.0,42.0,27.0,46.0,28.0,25.0,43.0,28.0,49.0,34.0,40.0,46.0,31.0,52.0,75.0,40.0,77.0,46.0,65.0,67.0,65.0,86.0,54.0,69.0,76.0,72.0,84.0,63.0,80.0,57.0,76.0,79.0,38.0,86.0,48.0,29.0,70.0,25.0,37.0,56.0,41.0,50.0,27.0,37.0,71.0,31.0,55.0,27.0,25.0,31.0,18.0,25.0,12.0,9.0,11.0,1.0,2.0,1.0,0.0,1.0,0.0,0.0,0.0,14.0,25.0,18.0,25.0,16.0,11.0,26.0,14.0,34.0,20.0,28.0,29.0,18.0,32.0,36.0,19.0,32.0,17.0,38.0,33.0,30.0,43.0,28.0,36.0,37.0,38.0,40.0,30.0,38.0,34.0,39.0,44.0,24.0,40.0,27.0,13.0,35.0,14.0,19.0,32.0,23.0,25.0,14.0,14.0,33.0,15.0,24.0,13.0,9.0,15.0,5.0,9.0,4.0,4.0,5.0,0.0,0.0,0.0,0.0,1.0,0.0,0.0,0.0,24.0,17.0,9.0,21.0,12.0,14.0,17.0,14.0,15.0,14.0,12.0,17.0,13.0,20.0,39.0,21.0,45.0,29.0,27.0,34.0,35.0,43.0,26.0,33.0,39.0,34.0,44.0,33.0,42.0,23.0,37.0,35.0,14.0,46.0,21.0,16.0,35.0,11.0,18.0,24.0,18.0,25.0,13.0,23.0,38.0,16.0,31.0,14.0,16.0,16.0,13.0,16.0,8.0,5.0,6.0,1.0,2.0,1.0,0.0,0.0,0.0,0.0,0.0,12.24242424,11.27733026,13.65591398,97,38,97,43,92,62,81,63,97,55,92,65,98,127,178,177,176,21.57575758,20.36823936,18.92473118,104.7146402,106.9047619,101.29870129999999,546,594,627,66.18181818,68.35443038,67.41935484,133.6007326,127.7979798,155.07017539999998,32.6007326,29.7979798,28.07017544,176.23762380000002,180.6122449,138.58267719999998,323,39.15151515,31.41542002,273,31.1827957,290,80.43478261,62.5,205.8823529,46.65012407,188,14.36170213,86.19047619,362,11.60220994,37.87878788,175,21.71428571,4.787234043,4.696132597,13.71428571,18946.55984,19880337.51,930.0,928.0,934.0,925.0,903.0,903.0,895.0,885.0,873.0,852.0,871.0,869.0,855.0,853.0,840.0,843.0,829.0,828.0,825.0,823.0,834.0,843.0,841.0,839.0,843.0,847.0,843.0,873.0,983.0,1107.0,1251.0,1224.0,1575.0,1424.0,1164.0,903.0,19.88033676,45.42176578,58.55031602,71.62856529999999,79.22401008,61.56837355,62.92649944,55.68316137,49.44584248,43.91273702,42.40370825,42.60491209,42.40370825,42.20250442,42.30310634,42.40370825,41.95099962,41.39768908,41.49829099,41.64919387,41.69949483,42.40370825,42.25280538,42.90671784,43.00731976,43.71153318,43.8121351,42.85641688,43.91273702,44.51634852,45.01935811,45.42176578,45.42176578,46.52838687,46.9810955,46.67928975,46.77989167,0,1,0,0,1,14609.44994,2782.80505,3811.3869670000004,4325.293036,1710.234745,13,65,0.005203159000000001,0,1.0,0.0,1.0,1.0
39091,2383,Cantabria,Cantabria,Vald√°liga,-6,902,908,244.335221,186.230875,0.122584,39.551285,39.4287,12.252008,7.2925699999999996,18295.70685,30655.3326,12359.62575,24409.12885,2709.935942,25.177889,7905.058456000001,7879.880566,3210.4553690000002,1889.763525,19.647525,8507.696403,8488.048878,3453.725533,1961.163345,27.659732,7118.506379,7090.846647,3266.47485,1569.379107,14.0,11.0,17.0,14.0,15.0,18.0,24,18,16,12,13,18,17,16,14,14,9,15,6,11,11,23.0,26.0,35.0,30.0,29.0,36.0,37,27,37,32,19,29,40,30,37,25,33,26,33,28,30,-9,-15,-18,-16,-14,-18,-13,-9,-21,-20,-6,-11,-23,-14,-23,-11,-24,-11,-27,-17,-19,1.048846269,0.797216988,1.197014505,0.956218838,0.972510373,1.151263192,1.4970059880000002,1.098029647,0.937591562,0.69124424,0.740951838,1.018387553,0.947708775,0.888642044,0.765780549,0.7651527570000001,0.496688742,0.82781457,0.331345262,0.607365689,0.77203044,1.723104585,1.884331062,2.464441628,2.049040366,1.880186722,2.302526383,2.3078842319999997,1.64704447,2.168180486,1.843317972,1.08292961,1.6407355019999998,2.229902999,1.6662038319999999,2.023848594,1.366344209,1.8197860369999999,1.4348785869999998,1.82239894,1.546021755,1.654350943,-0.674258316,-1.087114075,-1.267427123,-1.092821529,-0.907676349,-1.151263192,-0.8108782440000001,-0.5490148229999999,-1.230588925,-1.152073733,-0.34197777100000004,-0.622347949,-1.282194225,-0.777561788,-1.258068045,-0.601191452,-1.323480754,-0.607064018,-1.491053678,-0.938656065,-1.047755597,76,70,6,60,60,0,16,10,6,61,56,5,64,62,2,-3,-6,3,112,108,4,81,79,2,31,29,2,73,66,7,96,95,1,-23,-29,6,66,63,3,96,93,3,-30,-30,0,65,60,5,84,83,1,-19,-23,4,111,105,6,93,84,9,18,21,-3,114,106,8,116,114,2,-2,-8,6,91,83,8,59,57,2,32,26,6,50.0,81.0,62.0,82.0,79.0,67.0,86.0,61.0,92.0,81.0,78.0,155.0,62.0,123.0,154.0,79.0,136.0,159.0,100.0,173.0,173.0,130.0,149.0,181.0,173.0,173.0,198.0,167.0,194.0,171.0,172.0,189.0,155.0,188.0,154.0,142.0,189.0,138.0,118.0,137.0,121.0,171.0,131.0,128.0,157.0,107.0,144.0,132.0,96.0,107.0,90.0,86.0,56.0,49.0,29.0,21.0,19.0,12.0,9.0,6.0,0.0,0.0,0.0,19.0,41.0,34.0,47.0,48.0,34.0,40.0,31.0,51.0,45.0,41.0,83.0,38.0,71.0,81.0,42.0,64.0,88.0,58.0,95.0,90.0,77.0,82.0,100.0,89.0,85.0,108.0,95.0,119.0,108.0,90.0,102.0,87.0,110.0,98.0,67.0,105.0,68.0,59.0,78.0,48.0,90.0,58.0,69.0,82.0,50.0,71.0,58.0,41.0,44.0,36.0,34.0,24.0,15.0,10.0,3.0,4.0,2.0,0.0,1.0,0.0,0.0,0.0,31.0,40.0,28.0,35.0,31.0,33.0,46.0,30.0,41.0,36.0,37.0,72.0,24.0,52.0,73.0,37.0,72.0,71.0,42.0,78.0,83.0,53.0,67.0,81.0,84.0,88.0,90.0,72.0,75.0,63.0,82.0,87.0,68.0,78.0,56.0,75.0,84.0,70.0,59.0,59.0,73.0,81.0,73.0,59.0,75.0,57.0,73.0,74.0,55.0,63.0,54.0,52.0,32.0,34.0,19.0,18.0,15.0,10.0,9.0,5.0,0.0,0.0,0.0,9.016727866,9.550561798,10.10662958,338,102,327,101,325,112,286,119,327,120,325,106,221,218,624,586,598,25.45899633,25.32411409,27.72369031,108.5957447,108.4684685,109.6209913,1606,1507,1341,65.52427581,65.12532411,62.16968011,259.8542964,259.8852024,262.5935869,38.85429639,38.88520239,44.59358688,282.3529412,265.158371,274.31192660000005,389,15.87107303,29.775280900000002,689,26.425591100000002,570,76.12903226,176.9230769,233.33333330000002,46.80851064,550,11.27272727,74.95495495,832,9.735576923,33.91642371,349,14.32664756,5.090909091,4.807692308,8.88252149,50668.61551,97730952.07,2157.0,2150.0,2182.0,2191.0,2218.0,2272.0,2309.0,2299.0,2313.0,2317.0,2326.0,2314.0,2306.0,2351.0,2364.0,2414.0,2430.0,2410.0,2451.0,2503.0,2525.0,2541.0,2570.0,2595.0,2623.5,2652.0,2618.0,2753.0,3252.0,3434.0,3832.0,3626.0,3595.0,3758.0,3637.0,3566.0,97.7309494,36.48792958,37.21441388,38.45250684,36.78466261,37.10185998,39.20968765,35.13728272,33.2750272,28.16917278,26.7878294,27.13572329,26.84410636,26.55248942,26.29668509,25.99995207,25.8362373,25.61112949,25.07905648,24.65953738,24.86418084,24.70046607,24.18885741,24.05583916,23.59539137,23.67724875,23.80003483,23.70794527,23.66701658,23.52376616,23.62608789,23.24749748,22.69496013,22.41869145,22.32660189,21.99917235,22.07079756,0,0,2,0,3,22406.847859999998,3173.649654,4669.238963000001,7025.755178,2540.633788,53,346,0.022697745,0,1.0,0.0,1.0,1.0
39002,2384,Cantabria,Cantabria,Ampuero,2,710,708,221.39156,154.115443,0.122584,42.845379,42.722794,13.521795999999998,7.887071000000001,5790.680639,13682.7489,7892.068262000001,8971.024140000001,1892.8038960000001,7.619812,4578.718067,4571.098255,2178.055308,874.433641,2845.067381,10891.195029999999,8046.1276450000005,6435.683771,1697.1684699999998,20.705519,6715.403716,6694.698197,2249.270292,1350.066283,33.0,38.0,36.0,42.0,38.0,38.0,55,52,69,39,52,47,24,41,23,23,34,34,25,26,14,41.0,28.0,39.0,35.0,46.0,39.0,55,35,31,51,29,42,55,32,34,33,33,47,52,45,45,-8,10,-3,7,-8,-1,0,17,38,-12,23,5,-31,9,-11,-10,1,-13,-27,-19,-31,38.96103896,45.50898204,44.22604423,53.84615385,49.54367666,50.9383378,76.28294036,73.96870555,100.877193,57.35294118,76.58321059999999,69.73293769,36.69724771,65.18282989,37.70491803,39.93055556,62.3853211,62.3853211,47.34848485,49.90403071,65.86826347,48.40613932,33.53293413,47.91154791,44.87179487,59.97392438,52.27882038,76.28294036,49.78662873,45.32163743,75.0,42.70986745,62.31454006,84.09785933,50.87440382,55.73770492,57.29166667,58.71886121,86.23853211,98.48484848,86.37236084,89.82035928,-9.445100354,11.9760479,-3.685503686,8.974358974,-10.43024772,-1.340482574,0.0,24.18207681,55.55555556,-17.64705882,33.87334315,7.418397626,-47.40061162,14.30842607,-18.03278689,-17.36111111,1.779359431,-23.85321101,-51.13636364,-36.46833013,-61.8762475,184,174,10,174,159,15,10,15,-5,173,166,7,192,176,16,-19,-10,-9,152,141,11,197,163,34,-45,-22,-23,175,159,16,164,154,10,11,5,6,172,149,23,130,124,6,42,25,17,166,148,18,163,142,21,3,6,-3,274,237,37,177,167,10,97,70,27,227,206,21,174,172,2,53,34,19,244,228,16,163,140,23,81,88,-7,133.0,237.0,166.0,181.0,208.0,135.0,278.0,148.0,163.0,224.0,163.0,189.0,190.0,192.0,227.0,161.0,279.0,302.0,191.0,394.0,329.0,273.0,392.0,304.0,390.0,369.0,259.0,409.0,310.0,232.0,413.0,244.0,223.0,315.0,247.0,197.0,270.0,216.0,168.0,250.0,214.0,185.0,215.0,159.0,160.0,192.0,143.0,165.0,125.0,136.0,108.0,95.0,89.0,67.0,49.0,30.0,35.0,13.0,11.0,5.0,1.0,2.0,1.0,67.0,129.0,91.0,95.0,108.0,83.0,156.0,84.0,90.0,117.0,88.0,93.0,100.0,104.0,116.0,81.0,140.0,154.0,99.0,210.0,167.0,137.0,201.0,173.0,199.0,198.0,140.0,207.0,168.0,116.0,214.0,134.0,126.0,166.0,118.0,95.0,146.0,109.0,78.0,111.0,102.0,96.0,106.0,80.0,68.0,87.0,63.0,78.0,58.0,55.0,49.0,31.0,32.0,20.0,10.0,7.0,14.0,2.0,1.0,4.0,0.0,2.0,0.0,66.0,108.0,75.0,86.0,100.0,52.0,122.0,64.0,73.0,107.0,75.0,96.0,90.0,88.0,111.0,80.0,139.0,148.0,92.0,184.0,162.0,136.0,191.0,131.0,191.0,171.0,119.0,202.0,142.0,116.0,199.0,110.0,97.0,149.0,129.0,102.0,124.0,107.0,90.0,139.0,112.0,89.0,109.0,79.0,92.0,105.0,80.0,87.0,67.0,81.0,59.0,64.0,57.0,47.0,39.0,23.0,21.0,11.0,10.0,1.0,1.0,0.0,1.0,12.81767956,14.1764284,13.55311355,397,200,442,272,535,274,329,264,442,321,535,318,593,592,726,784,940,20.05524862,18.74252929,21.52014652,104.6353872,104.0487805,100.4589261,2430,2806,2836,67.12707182,67.08104231,64.92673993,493.8765432,620.9401283,625.145275,29.87654321,27.940128299999998,33.14527504,156.46551719999997,132.20910619999998,158.7837838,784,21.65745856,35.02271097,1465,28.91483516,1263,88.88888889,132.5153374,120.5357143,47.65404183,843,19.6915777,87.26829268,1789,13.24762437,33.63928408,733,18.14461119,8.896797153,6.036892119,9.004092769,35640.325939999995,32467579.9,4368.0,4319.0,4288.0,4219.0,4222.0,4181.0,4184.0,4228.0,4255.0,4281.0,4230.0,4183.0,4179.0,4052.0,3951.0,3837.0,3682.0,3671.0,3620.0,3602.0,3517.0,3491.0,3497.0,3424.0,3380.5,3337.0,3324.0,3162.0,3382.0,3581.0,4117.0,4159.0,3846.0,3547.0,3624.0,3006.0,32.46757889,92.58466763,111.6190404,109.24744380000001,118.45663059999998,128.0970169,126.8034187,110.29464229999999,104.1654511,97.38946076,102.37905359999999,102.7794531,104.1192511,105.45904920000001,107.70744599999999,107.5226463,108.32344509999999,110.94144140000002,111.4958406,113.0666383,113.4054379,118.17943100000001,121.690626,124.8014216,128.71301599999998,128.83621580000002,130.28381370000002,131.8546115,131.0538126,130.2222138,128.86701580000002,128.7746159,130.03741409999998,129.9450142,132.0702112,133.0250098,134.5342076,0,1,0,1,1,9542.464781,5162.058774,6359.811968999999,3141.984828,2510.6787,38,250,8.01582e-05,0,1.0,0.0,1.0,1.0
39004,2385,Cantabria,Cantabria,Arenas de Igu√±a,132,1216,1084,576.39915,240.255629,0.0,45.805107,45.805107,16.547057000000002,8.424658,12476.23724,22462.80629,9986.56905,17407.61233,1843.1929460000001,12.936351,10421.8262,10408.88984,4636.723312,2696.320154,28.382859000000003,9263.702483,9235.319624,4126.3075340000005,2268.863466,52.92775,10861.02648,10808.09873,4954.033208,2641.067273,12.0,4.0,5.0,14.0,7.0,8.0,9,13,7,7,10,3,7,8,10,12,9,13,9,9,12,19.0,20.0,27.0,26.0,28.0,21.0,30,24,18,25,30,23,23,28,29,33,23,32,23,26,17,-7,-16,-22,-12,-21,-13,-21,-11,-11,-18,-20,-20,-16,-20,-19,-21,-14,-19,-14,-17,-5,56.33802817,20.6185567,26.45502646,81.87134503,42.68292683,48.7804878,50.84745763,76.92307692,41.42011834,42.42424242,58.47953216,17.34104046,38.67403315,51.28205128,64.51612903,76.92307692,64.74820144,93.52517986,61.64383562,57.69230769,80.53691275,89.20187793,103.0927835,142.8571429,152.0467836,170.7317073,128.0487805,169.4915254,142.0118343,106.5088757,151.5151515,175.43859650000002,132.94797690000001,127.07182320000001,179.4871795,187.0967742,211.5384615,154.3624161,230.2158273,157.5342466,166.66666669999998,114.09395970000001,-32.86384977,-82.4742268,-116.4021164,-70.1754386,-128.0487805,-79.26829268,-118.6440678,-65.0887574,-65.0887574,-109.0909091,-116.9590643,-115.60693640000001,-88.39779006,-128.20512820000002,-122.5806452,-134.6153846,-93.95973154,-136.6906475,-95.89041096,-108.974359,-33.55704698,75,75,0,40,39,1,35,36,-1,48,45,3,55,55,0,-7,-10,3,48,48,0,50,50,0,-2,-2,0,29,28,1,57,54,3,-28,-26,-2,31,30,1,46,46,0,-15,-16,1,53,52,1,58,51,7,-5,1,-6,69,62,7,54,54,0,15,8,7,51,47,4,54,54,0,-3,-7,4,91,90,1,52,52,0,39,38,1,56.0,39.0,38.0,55.0,47.0,50.0,51.0,45.0,93.0,43.0,78.0,130.0,56.0,111.0,137.0,76.0,129.0,94.0,107.0,119.0,100.0,143.0,82.0,133.0,122.0,112.0,161.0,99.0,160.0,133.0,107.0,147.0,132.0,146.0,131.0,96.0,149.0,109.0,89.0,121.0,94.0,163.0,100.0,116.0,120.0,87.0,116.0,118.0,69.0,92.0,90.0,75.0,59.0,33.0,31.0,22.0,14.0,7.0,6.0,3.0,3.0,0.0,0.0,24.0,23.0,19.0,27.0,23.0,33.0,24.0,26.0,48.0,20.0,42.0,79.0,30.0,61.0,86.0,37.0,78.0,53.0,57.0,73.0,46.0,75.0,44.0,66.0,79.0,54.0,92.0,55.0,94.0,65.0,51.0,68.0,76.0,83.0,80.0,44.0,70.0,55.0,44.0,72.0,42.0,74.0,48.0,51.0,54.0,35.0,52.0,48.0,30.0,33.0,38.0,31.0,22.0,10.0,8.0,6.0,3.0,2.0,3.0,2.0,0.0,0.0,0.0,32.0,16.0,19.0,28.0,24.0,17.0,27.0,19.0,45.0,23.0,36.0,51.0,26.0,50.0,51.0,39.0,51.0,41.0,50.0,46.0,54.0,68.0,38.0,67.0,43.0,58.0,69.0,44.0,66.0,68.0,56.0,79.0,56.0,63.0,51.0,52.0,79.0,54.0,45.0,49.0,52.0,89.0,52.0,65.0,66.0,52.0,64.0,70.0,39.0,59.0,52.0,44.0,37.0,23.0,23.0,16.0,11.0,5.0,3.0,1.0,3.0,0.0,0.0,9.392838609,7.221609702,9.51262478,312,81,296,59,267,87,229,100,296,72,267,75,131,162,541,505,493,28.07472756,27.83902977,28.94891368,103.4846885,105.2036199,101.5384615,1205,1178,1048,62.53243383,64.93936053,61.53846154,225.8962656,173.8692699,209.04198469999997,44.89626556,42.86926995,47.04198473,298.8950276,385.4961832,304.3209877,1025,53.19148936,26.07497244,473,27.65707575,471,68.46153846,139.7435897,346.51162789999995,44.56177402,422,9.004739336,71.38009050000001,631,6.18066561,35.26627219,298,18.79194631,4.502369668,2.535657686,10.73825503,58755.39393,86761259.62,1703.0,1665.0,1679.0,1676.0,1690.0,1711.0,1752.0,1775.0,1811.0,1792.0,1806.0,1814.0,1837.0,1830.0,1867.0,1882.0,1897.0,1918.0,1927.0,1984.0,2014.0,2041.0,2045.0,2085.0,2125.0,2165.0,2282.0,2599.0,2763.0,3041.0,2812.0,2729.0,2607.0,2225.0,2499.0,2414.0,86.76126099,27.82347758,28.803177500000004,25.64508601,30.04797268,31.45413021,32.41077836,35.05020519,31.84601017,29.95576563,26.30206124,24.95353313,24.49249787,24.03146262,23.57042736,23.52432384,23.21312504,22.8673486,22.21037336,22.10664043,21.86459692,21.6917087,21.51882048,21.09236287,21.17304404,20.90794877,20.81574172,20.65437938,20.87337113,20.458439399999996,20.19334413,19.72078299,19.47873948,19.31737714,19.35195479,19.19059245,19.62857594,0,0,0,0,2,21078.3992,3115.216262,9250.420268,9213.251748,3711.5045119999995,14,76,0.0012769810000000002,0,0.97,0.09,1.0,1.0
39005,2386,Cantabria,Cantabria,Argo√±os,0,212,212,45.127607,51.746085,0.0,27.644512,27.644512,6.833467999999999,6.755605,1525.743531,5122.269401,3596.5258700000004,3376.41651,949.147817,3050.783798,5152.201588,2101.41779,4032.6736659999997,501.091276,4037.734292,6191.334239,2153.5999469999997,5158.556262,552.801035,3053.302067,5258.723229,2205.421162,4122.8103439999995,540.818167,13.0,11.0,8.0,9.0,20.0,20.0,15,14,14,17,19,17,13,10,18,14,10,14,12,15,8,5.0,3.0,1.0,2.0,12.0,3.0,6,7,8,10,11,12,8,10,13,21,12,13,13,19,7,8,8,7,7,8,17,9,7,6,7,8,5,5,0,5,-7,-2,1,-1,-4,1,11.94852941,10.3286385,7.590132827,8.704061896,19.62708538,19.90049751,15.29051988,14.72134595,14.95726496,19.01565996,21.93995381,20.02355713,15.87301587,13.07189542,23.80952381,18.7416332,14.26533524,19.97146933,17.54385965,23.21981424,20.47244094,4.595588235,2.816901408,0.948766603,1.934235977,11.77625123,2.985074627,6.116207951,7.360672976,8.547008547,11.18568233,12.70207852,14.13427562,9.768009767999999,13.07189542,17.1957672,28.112449800000004,16.23815968,18.54493581,19.00584795,29.41176471,11.02362205,7.352941176,7.511737089,6.641366224,6.769825919,7.850834151,16.91542289,9.174311927,7.360672976,6.41025641,7.829977629,9.237875289,5.889281508,6.105006105,0.0,6.613756614,-9.3708166,-2.706359946,1.426533524,-1.4619883040000001,-6.191950464,1.57480315,87,81,6,77,77,0,10,4,6,93,91,2,96,91,5,-3,0,-3,131,130,1,95,93,2,36,37,-1,89,75,14,102,100,2,-13,-25,12,69,64,5,73,72,1,-4,-8,4,104,92,12,93,93,0,11,-1,12,97,91,6,74,72,2,23,19,4,133,119,14,88,87,1,45,32,13,144,139,5,91,87,4,53,52,1,66.0,92.0,60.0,90.0,97.0,58.0,101.0,93.0,59.0,106.0,68.0,65.0,91.0,91.0,75.0,71.0,89.0,101.0,70.0,154.0,107.0,127.0,154.0,107.0,162.0,165.0,95.0,165.0,138.0,78.0,162.0,126.0,75.0,162.0,106.0,57.0,144.0,83.0,41.0,98.0,53.0,49.0,91.0,51.0,27.0,48.0,34.0,35.0,43.0,32.0,21.0,22.0,27.0,11.0,12.0,8.0,9.0,2.0,2.0,1.0,1.0,0.0,1.0,32.0,45.0,30.0,46.0,49.0,34.0,60.0,52.0,31.0,43.0,38.0,44.0,53.0,55.0,38.0,41.0,44.0,57.0,36.0,83.0,44.0,64.0,79.0,57.0,85.0,79.0,45.0,81.0,78.0,45.0,83.0,59.0,34.0,83.0,51.0,35.0,70.0,51.0,27.0,54.0,29.0,24.0,52.0,29.0,13.0,24.0,18.0,14.0,25.0,12.0,13.0,11.0,13.0,3.0,3.0,2.0,4.0,0.0,0.0,0.0,0.0,0.0,0.0,34.0,47.0,30.0,44.0,48.0,24.0,41.0,41.0,28.0,63.0,30.0,21.0,38.0,36.0,37.0,30.0,45.0,44.0,34.0,71.0,63.0,63.0,75.0,50.0,77.0,86.0,50.0,84.0,60.0,33.0,79.0,67.0,41.0,79.0,55.0,22.0,74.0,32.0,14.0,44.0,24.0,25.0,39.0,22.0,14.0,24.0,16.0,21.0,18.0,20.0,8.0,11.0,14.0,8.0,9.0,6.0,5.0,2.0,2.0,1.0,1.0,0.0,1.0,15.6360424,16.95730607,14.01308615,83,82,104,136,148,119,71,95,104,146,148,138,282,257,154,207,317,13.60424028,12.44738425,17.28462377,109.62962959999999,108.6574655,106.5315315,801,1174,1260,70.75971731,70.59530968,68.70229008,196.2259675,299.6320273,282.1587302,19.22596754,17.63202726,25.15873016,87.00564972,73.40425532,123.34630349999999,472,41.69611307,36.74082983,611,28.57142857,524,63.07692308,122.05882350000002,135.84905659999998,52.77777778,285,21.05263158,90.46424090000001,721,12.76005548,36.26126126,322,20.49689441,10.52631579,6.518723994,10.55900621,10356.63204,5572748.972,1834.0,1788.0,1748.0,1723.0,1713.0,1720.0,1744.0,1705.0,1711.0,1696.0,1712.0,1663.0,1650.0,1614.0,1535.0,1444.0,1355.0,1260.0,1132.0,1000.0,945.0,868.0,811.0,805.0,791.5,778.0,650.0,580.0,553.0,780.0,797.0,713.0,702.0,634.0,658.0,511.0,5.572749138,91.69621445,118.07457749999999,113.76790600000001,125.970142,127.9440331,143.0173834,139.9668244,99.23288961,104.07789509999999,116.6390203,139.6079351,142.03043780000002,144.4529406,145.5296084,155.7579533,169.57519109999998,179.4446467,203.13134,226.1002548,243.14749619999998,259.11806980000006,275.44753260000005,289.6236597,296.083667,298.4164474,307.2092351,304.3381207,307.02979039999997,305.95312260000003,312.9514638,308.6447923,307.38867969999995,309.1831262,313.6692424,320.84702819999995,329.101482,0,1,0,0,1,6245.39152,3052.1902410000002,3986.185575,2974.540105,1077.7923119999998,23,119,0.003080937,0,1.0,0.37,1.0,1.0
39006,2387,Cantabria,Cantabria,Arnuero,-1,230,231,53.801767000000005,42.729821,0.0,37.476040000000005,37.476040000000005,6.494651,5.864903,4978.744538,12372.92486,7394.180320999999,9203.840490999999,1725.148657,2483.8469210000003,10023.59868,7539.751754999999,6511.532412,1957.445639,2855.144148,10471.39271,7616.248564,7195.05795,1784.2085690000001,3030.5427489999997,10193.95087,7163.408115,6655.354559,1944.6585149999999,17.0,20.0,19.0,16.0,19.0,15.0,22,17,18,14,14,14,12,9,18,10,12,17,16,11,11,13.0,28.0,22.0,20.0,14.0,25.0,24,28,17,26,36,25,30,22,26,25,22,29,34,30,32,4,-8,-3,-4,5,-10,-2,-11,1,-12,-22,-11,-18,-13,-8,-15,-10,-12,-18,-19,-21,42.28855721,49.75124378,48.96907216,40.92071611,49.35064935,40.43126685,61.79775281,49.27536232,54.38066465,44.02515723,45.90163934,44.16403785,37.61755486,29.03225806,56.42633229,32.67973856,42.40282686,60.07067138,57.55395683,39.56834532,65.38461538,32.33830846,69.65174129,56.70103093,51.15089514,36.36363636,67.38544474,67.41573034,81.15942029,51.35951662,81.76100629,118.03278689999999,78.86435331,94.04388715,70.96774194,81.50470219,81.69934641,74.07407407,102.47349820000001,122.30215829999999,107.91366909999999,123.07692309999999,9.950248756,-19.90049751,-7.731958763,-10.23017903,12.98701299,-26.9541779,-5.617977528,-31.88405797,3.021148036,-37.73584906,-72.13114754,-34.70031546,-56.42633229,-41.93548387,-25.07836991,-49.01960784,-33.67003367,-42.40282686,-64.74820144,-68.34532374,-80.76923077,109,105,4,89,86,3,20,19,1,98,92,6,99,92,7,-1,0,-1,155,146,9,120,104,16,35,42,-7,88,78,10,96,90,6,-8,-12,4,124,102,22,101,92,9,23,10,13,117,104,13,93,90,3,24,14,10,130,107,23,108,104,4,22,3,19,146,111,35,122,114,8,24,-3,27,178,160,18,108,105,3,70,55,15,71.0,76.0,74.0,72.0,94.0,70.0,87.0,70.0,76.0,104.0,89.0,100.0,96.0,108.0,126.0,87.0,122.0,144.0,103.0,167.0,137.0,134.0,162.0,146.0,157.0,178.0,150.0,180.0,172.0,143.0,176.0,169.0,111.0,180.0,136.0,114.0,173.0,130.0,79.0,153.0,106.0,103.0,117.0,84.0,105.0,96.0,101.0,97.0,65.0,74.0,75.0,61.0,55.0,41.0,27.0,18.0,13.0,3.0,6.0,2.0,2.0,0.0,0.0,34.0,35.0,41.0,42.0,55.0,32.0,41.0,33.0,38.0,56.0,43.0,58.0,39.0,65.0,65.0,37.0,69.0,80.0,65.0,88.0,59.0,72.0,86.0,73.0,83.0,84.0,88.0,92.0,91.0,80.0,93.0,90.0,65.0,86.0,79.0,60.0,84.0,72.0,41.0,88.0,54.0,51.0,62.0,43.0,48.0,40.0,43.0,39.0,28.0,28.0,24.0,18.0,9.0,18.0,7.0,4.0,4.0,0.0,1.0,0.0,0.0,0.0,0.0,37.0,41.0,33.0,30.0,39.0,38.0,46.0,37.0,38.0,48.0,46.0,42.0,57.0,43.0,61.0,50.0,53.0,64.0,38.0,79.0,78.0,62.0,76.0,73.0,74.0,94.0,62.0,88.0,81.0,63.0,83.0,79.0,46.0,94.0,57.0,54.0,89.0,58.0,38.0,65.0,52.0,52.0,55.0,41.0,57.0,56.0,58.0,58.0,37.0,46.0,51.0,43.0,46.0,23.0,20.0,14.0,9.0,3.0,5.0,2.0,2.0,0.0,0.0,11.54249738,11.33679735,10.72761194,252,109,262,117,281,113,184,111,262,123,281,117,240,230,436,444,524,22.87513116,20.97307511,24.44029851,102.33545649999999,102.5837321,99.07149489,1250,1433,1390,65.58237146,67.69012754,64.83208955,254.88,270.9839498,267.69784169999997,34.88,30.98394976,37.69784173,198.18181819999998,185.0,227.826087,452,23.71458552,32.07368918,679,26.77238806,574,79.0,146.0674157,166.34615380000002,44.9044586,423,17.49408983,79.0430622,826,9.200968523,32.68337976,352,20.17045455,7.80141844,4.963680387,10.51136364,25422.070330000002,24761082.19,2144.0,2106.0,2103.0,2108.0,2098.0,2091.0,2125.0,2107.0,2122.0,2115.0,2101.0,2117.0,2122.0,2141.0,2073.0,2026.0,1956.0,1937.0,1906.0,1900.0,1796.0,1783.0,1787.0,1739.0,1775.0,1811.0,1884.0,1802.0,1937.0,2151.0,2103.0,2117.0,1974.0,2007.0,1664.0,1565.0,24.7610817,63.20402393,67.20223375,81.05461727,79.72188066,85.49707263,84.93166922,86.87019519,78.22760022,72.77549592,76.08714446,73.13896954,71.68507506,70.23118058,72.16970656,72.00816273,72.53318018,76.73331979,76.97563553,78.22760022,78.99493342,81.82195047,83.72009048,86.46633561,85.69900241,85.49707263,84.8508973,85.41630071,85.69900241,85.09321305,85.82016029,84.44703772,84.72973943,85.13359901,84.93166922,85.05282709,86.58749349,0,0,4,0,3,11773.96289,1886.4444449999999,2330.4818960000002,3333.812349,1209.848217,95,475,0.06531948,0,0.1,0.04,1.0,1.0
39007,2388,Cantabria,Cantabria,Arredondo,150,1389,1239,599.953981,269.778316,0.122584,65.276955,65.15437,20.168423999999998,9.630402,15971.2642,24824.257380000003,8852.993186,20722.702980000002,1939.566738,9518.068036,16107.58485,6589.516809000001,12422.03253,1381.674271,9372.054471,17810.51895,8438.464482,13680.1916,1977.81975,6307.81641,15129.94485,8822.128440999999,11231.36391,1963.497989,5.0,0.0,2.0,5.0,3.0,2.0,5,4,2,3,3,4,4,2,0,0,3,3,2,1,1,8.0,5.0,11.0,5.0,10.0,8.0,4,12,13,8,8,12,10,3,10,12,8,14,10,4,8,-3,-5,-9,0,-7,-6,1,-8,-11,-5,-5,-8,-6,-1,-10,-12,-5,-11,-8,-3,-7,12.75510204,0,4.016064257,9.881422925,5.988023952,3.937007874,9.596928983,7.648183556,3.5460992910000004,4.709576138,3.8119440910000004,4.90797546,4.807692308,2.3724792409999997,0.0,0.0,3.374578178,3.374578178,2.166847237,1.0741138559999999,5.307855626,20.40816327,11.38952164,22.08835341,9.881422925,19.96007984,15.7480315,7.677543186,22.94455067,23.04964539,12.558869699999999,10.16518424,14.72392638,12.01923077,3.5587188610000005,12.07729469,14.150943400000001,9.345794393,15.7480315,10.83423619,4.2964554239999995,8.492569002,-7.653061224,-11.38952164,-18.07228916,0,-13.97205589,-11.81102362,1.919385797,-15.29636711,-19.5035461,-7.849293564,-6.353240152000001,-9.81595092,-7.211538462,-1.18623962,-12.07729469,-14.150943400000001,-5.841121495,-12.37345332,-8.667388949,-3.222341568,-7.430997877,7,7,0,19,19,0,-12,-12,0,24,24,0,23,23,0,1,1,0,20,20,0,22,20,2,-2,0,-2,25,20,5,35,35,0,-10,-15,5,26,23,3,29,29,0,-3,-6,3,37,32,5,26,26,0,11,6,5,33,31,2,42,41,1,-9,-10,1,34,29,5,28,28,0,6,1,5,45,45,0,23,23,0,22,22,0,7.0,12.0,11.0,17.0,9.0,8.0,13.0,12.0,14.0,11.0,14.0,35.0,17.0,18.0,29.0,11.0,34.0,47.0,23.0,41.0,32.0,31.0,31.0,35.0,30.0,39.0,26.0,42.0,30.0,26.0,39.0,24.0,44.0,36.0,35.0,51.0,34.0,46.0,37.0,36.0,44.0,40.0,40.0,39.0,33.0,36.0,32.0,40.0,26.0,30.0,22.0,16.0,16.0,24.0,4.0,9.0,6.0,1.0,2.0,1.0,0.0,0.0,0.0,2.0,4.0,8.0,9.0,7.0,3.0,6.0,6.0,11.0,4.0,12.0,20.0,12.0,10.0,16.0,8.0,18.0,20.0,16.0,19.0,22.0,19.0,19.0,19.0,15.0,27.0,16.0,23.0,19.0,13.0,25.0,14.0,29.0,21.0,19.0,29.0,23.0,31.0,19.0,18.0,24.0,25.0,28.0,22.0,15.0,18.0,18.0,25.0,13.0,15.0,10.0,7.0,9.0,11.0,2.0,3.0,2.0,0.0,0.0,1.0,0.0,0.0,0.0,5.0,8.0,3.0,8.0,2.0,5.0,7.0,6.0,3.0,7.0,2.0,15.0,5.0,8.0,13.0,3.0,16.0,27.0,7.0,22.0,10.0,12.0,12.0,16.0,15.0,12.0,10.0,19.0,11.0,13.0,14.0,10.0,15.0,15.0,16.0,22.0,11.0,15.0,18.0,18.0,20.0,15.0,12.0,17.0,18.0,18.0,14.0,15.0,13.0,15.0,12.0,9.0,7.0,13.0,2.0,6.0,4.0,1.0,2.0,0.0,0.0,0.0,0.0,5.882352941000001,6.382978723,7.872340426,77,11,81,16,73,20,89,22,81,17,73,17,33,37,166,172,159,29.59001783,33.2688588,33.82978723,127.1255061,133.93665159999998,133.8308458,362,312,274,64.52762923,60.34816248,58.29787234,78.85635359,88.12820513,95.02919708,45.85635359,55.12820513,58.02919708,503.030303,521.2121212000001,429.7297297,459,81.81818182,27.27272727,141,26.80851064,126,105.7142857,328.57142860000005,309.0909091,45.74898785,113,9.734513274,80.09049774,177,6.7796610170000005,36.815920399999996,74,9.459459459,2.654867257,4.519774011,6.756756757000001,31531.45563,46794719.25,470.0,452.0,452.0,470.0,472.0,480.0,498.0,507.0,506.0,522.0,515.0,517.0,525.0,532.0,546.0,547.0,558.0,569.0,561.0,598.0,620.0,635.0,639.0,645.0,656.5,668.0,670.0,812.0,1052.0,1216.0,1361.0,1370.0,1543.0,1496.0,1527.0,1538.0,46.7947197,32.86695614,32.63188689,31.96941898,32.97380581,29.27680749,29.084478100000002,25.98583789,22.48116896,17.35238517,14.31785476,14.27511489,14.02936067,13.78360645,13.65538685,13.56990712,13.24935813,12.77921962,11.98853212,12.15949158,11.92442232,11.68935306,11.66798313,11.36880408,11.21921455,11.04825509,11.00551522,11.15510475,10.81318583,10.83455576,10.64222637,10.25756759,10.08660813,10.04386826,9.659209478,9.659209478,10.04386826,0,1,0,0,2,22397.26535,2018.072648,6538.230525999999,11444.21227,3057.8698649999997,27,152,0.011340343999999999,0,0.0,0.0,0.97,0.7
39008,2389,Cantabria,Cantabria,Astillero (El),-2,85,87,13.677182,14.040871,0.0,13.660756,13.660756,2.85807,2.613868,41.014223,3689.8077340000004,3648.793511,1789.685783,937.9489169999999,28.658199,2183.188048,2154.52985,1329.404816,510.135263,39.626903999999996,1971.0277820000001,1931.4008780000001,958.2325050000001,475.51912599999997,20.757125,1679.512229,1658.7551039999998,751.046023,352.432341,137.0,131.0,159.0,176.0,176.0,202.0,213,218,216,201,229,186,211,196,164,175,140,148,130,118,99,116.0,95.0,130.0,116.0,112.0,114.0,104,114,113,124,143,141,145,157,132,123,142,159,141,149,165,21,36,29,60,64,88,109,104,103,77,86,45,66,39,32,52,-2,-11,-11,-31,-66,306.4876957,292.4107143,358.9164786,365.1452282,369.7478992,461.1872146,472.2838137,394.2133816,424.36149309999996,432.25806449999993,505.51876380000004,364.70588239999995,437.75933610000004,451.61290319999995,373.57630980000005,377.15517239999997,316.027088,334.0857788,311.7505995,291.3580247,346.835443,259.50783,212.0535714,293.4537246,240.6639004,235.2941176,260.2739726,230.5986696,206.1482821,222.0039293,266.6666667,315.6732892,276.47058819999995,300.8298755,361.7511521,300.6833713,265.08620690000004,316.9642857,358.9164786,338.1294964,367.9012346,417.721519,46.97986577,80.35714286,65.46275395,124.4813278,134.4537815,200.913242,241.6851441,188.0650995,202.3575639,165.5913978,189.84547460000002,88.23529412,136.9294606,89.86175115,72.8929385,112.0689655,-4.464285714,-24.83069977,-26.37889688,-76.54320988,-167.0886076,834,771,63,837,810,27,-3,-39,36,1017,941,76,727,703,24,290,238,52,877,812,65,836,798,38,41,14,27,761,697,64,891,841,50,-130,-144,14,817,706,111,782,759,23,35,-53,88,851,755,96,814,781,33,37,-26,63,893,763,130,852,829,23,41,-66,107,881,741,140,810,793,17,71,-52,123,812,738,74,732,715,17,80,23,57,662.0,1092.0,641.0,916.0,857.0,500.0,1093.0,679.0,684.0,901.0,696.0,837.0,756.0,869.0,1182.0,739.0,1325.0,1385.0,973.0,1829.0,1419.0,1284.0,1767.0,1264.0,1816.0,1550.0,1196.0,1722.0,1302.0,1120.0,1503.0,1229.0,935.0,1279.0,1028.0,720.0,1147.0,860.0,524.0,998.0,606.0,604.0,819.0,538.0,579.0,546.0,535.0,475.0,389.0,413.0,322.0,344.0,241.0,180.0,164.0,97.0,66.0,54.0,29.0,4.0,11.0,3.0,4.0,336.0,571.0,322.0,441.0,440.0,256.0,578.0,346.0,338.0,472.0,353.0,416.0,375.0,433.0,550.0,377.0,654.0,677.0,482.0,881.0,740.0,649.0,915.0,630.0,855.0,808.0,621.0,892.0,673.0,548.0,760.0,619.0,478.0,632.0,504.0,359.0,572.0,412.0,243.0,461.0,281.0,299.0,375.0,250.0,249.0,240.0,225.0,191.0,153.0,161.0,109.0,121.0,67.0,51.0,41.0,22.0,18.0,9.0,8.0,1.0,3.0,1.0,0.0,326.0,521.0,319.0,475.0,417.0,244.0,515.0,333.0,346.0,429.0,343.0,421.0,381.0,436.0,632.0,362.0,671.0,708.0,491.0,948.0,679.0,635.0,852.0,634.0,961.0,742.0,575.0,830.0,629.0,572.0,743.0,610.0,457.0,647.0,524.0,361.0,575.0,448.0,281.0,537.0,325.0,305.0,444.0,288.0,330.0,306.0,310.0,284.0,236.0,252.0,213.0,223.0,174.0,129.0,123.0,75.0,48.0,45.0,21.0,3.0,8.0,2.0,4.0,12.46499556,14.97862639,14.74387282,1316,909,1447,1271,1922,1316,918,916,1447,1357,1922,1355,2628,2671,2234,2462,3325,15.25852059,14.03248789,18.35394127,94.04903909999999,96.67077682,94.96340938,10582,12455,12120,72.27648385,70.98888572,66.90218591,1846.111321,2647.767162,2698.433993,21.11132111,19.76716178,27.433993400000002,122.41095890000001,93.68340944,124.4852115,1213,8.284953214,36.75121117,6448,31.98829764,5795,62.60454002,123.56321840000001,127.3029967,48.16434725,3634,17.63896533,90.07958749,8036,13.58885017,34.54584589,3210,20.62305296,8.778205834,6.483325037,10.15576324,12525.42965,6494233.405,18116.0,18134.0,18111.0,18108.0,18120.0,18134.0,18297.0,18282.0,18005.0,17938.0,17675.0,17545.0,17360.0,17065.0,16393.0,16032.0,15635.0,15424.0,14641.0,14202.0,13798.0,13348.0,13263.0,12920.0,12965.0,13010.0,12587.0,11524.0,9142.0,6759.0,5430.0,5345.0,5415.0,5058.0,5782.0,3582.0,6.494233607999999,551.566238,890.3283049,778.8447882999999,833.8166328,823.0378397999999,836.1263742000001,1040.769459,1407.7103710000001,1774.4972989999999,1938.180971,2003.315677,1996.386453,1989.4572289999999,2042.273315,2055.361849,2124.65409,2186.863125,2254.461555,2375.030054,2407.520416,2468.651571,2524.2393469999997,2627.71576,2673.140673,2701.6274829999998,2721.645242,2762.142707,2772.459552,2815.112776,2817.422517,2792.323328,2790.167569,2788.3197760000003,2788.781724,2792.323328,2789.551638,0,2,6,1,1,6453.595185,6767.737940000001,764.868629,1535.604888,1266.740508,20,91,0.049606044,0,0.99,0.99,1.0,1.0
39012,2390,Cantabria,Cantabria,Cabez√≥n de la Sal,82,634,552,213.410409,95.176967,0.0,42.772232,42.772232,8.746998,6.616377000000001,9890.434019,20206.08749,10315.653470000001,15515.61437,2610.771199,25.609788,4519.9404509999995,4494.330663000001,1541.826932,984.66709,35.902236,4688.488423,4652.5861859999995,1995.7320379999999,1072.116284,12.505533999999999,5094.776489,5082.270955,1933.4014339999999,1175.65238,75.0,69.0,80.0,76.0,68.0,75.0,81,100,119,67,79,80,68,62,82,69,66,53,60,45,52,67.0,67.0,73.0,76.0,73.0,87.0,58,74,76,61,76,84,87,66,80,81,74,78,69,78,93,8,2,7,0,-5,-12,23,26,43,6,3,-4,-19,-4,2,-12,-8,-25,-9,-33,-41,320.5128205,296.1373391,340.4255319,331.8777293,302.2222222,339.3665158,385.7142857,473.93364929999996,572.1153846,323.6714976,376.19047620000003,382.77511960000004,331.7073171,313.1313131,431.57894739999995,361.25654449999996,379.31034480000005,304.59770110000005,333.3333333,258.6206897,436.04651160000003,286.3247863,287.5536481,310.6382979,331.8777293,324.4444444,393.6651584,276.19047620000003,350.7109005,365.3846154,294.6859903,361.9047619,401.9138756,424.3902438999999,333.3333333,421.05263160000004,424.08376960000004,406.59340660000004,448.27586210000004,383.3333333,448.27586210000004,540.6976744,34.18803419,8.583690987,29.78723404,0,-22.22222222,-54.29864253,109.5238095,123.22274879999999,206.73076919999997,28.98550725,14.28571429,-19.13875598,-92.68292683,-20.2020202,10.52631579,-62.82722513,-43.95604396,-143.67816090000002,-50.0,-189.65517240000003,-238.372093,288,262,26,236,227,9,52,35,17,303,276,27,264,254,10,39,22,17,310,292,18,252,246,6,58,46,12,291,274,17,289,269,20,2,5,-3,304,275,29,282,267,15,22,8,14,353,326,27,296,285,11,57,41,16,346,317,29,350,333,17,-4,-16,12,403,351,52,289,282,7,114,69,45,300,267,33,282,270,12,18,-3,21,251.0,457.0,355.0,385.0,411.0,344.0,487.0,358.0,410.0,394.0,410.0,515.0,359.0,483.0,630.0,374.0,574.0,636.0,399.0,678.0,662.0,518.0,712.0,670.0,713.0,699.0,664.0,698.0,671.0,633.0,675.0,680.0,437.0,679.0,492.0,349.0,642.0,405.0,278.0,460.0,314.0,316.0,409.0,274.0,317.0,298.0,298.0,254.0,217.0,199.0,169.0,198.0,139.0,99.0,95.0,51.0,34.0,21.0,15.0,7.0,1.0,2.0,2.0,124.0,248.0,185.0,197.0,207.0,180.0,239.0,188.0,223.0,200.0,231.0,264.0,175.0,257.0,310.0,203.0,276.0,310.0,204.0,311.0,349.0,250.0,348.0,325.0,339.0,341.0,326.0,329.0,326.0,342.0,333.0,339.0,228.0,318.0,269.0,173.0,295.0,191.0,132.0,247.0,165.0,157.0,188.0,110.0,152.0,138.0,139.0,101.0,73.0,83.0,52.0,74.0,48.0,28.0,25.0,11.0,5.0,2.0,3.0,0.0,0.0,1.0,0.0,127.0,209.0,170.0,188.0,204.0,164.0,248.0,170.0,187.0,194.0,179.0,251.0,184.0,226.0,320.0,171.0,298.0,326.0,195.0,367.0,313.0,268.0,364.0,345.0,374.0,358.0,338.0,369.0,345.0,291.0,342.0,341.0,209.0,361.0,223.0,176.0,347.0,214.0,146.0,213.0,149.0,159.0,221.0,164.0,165.0,160.0,159.0,153.0,144.0,116.0,117.0,124.0,91.0,71.0,70.0,40.0,29.0,19.0,12.0,7.0,1.0,1.0,2.0,14.25266675,14.73203557,13.57427777,703,521,732,583,952,563,495,588,732,643,952,560,1226,1123,1198,1292,1699,15.3964786,15.52511416,20.536685600000002,97.53744605,96.73758865,91.50462963,5474,5804,5451,70.35085465,69.74285028,65.88903663,1130.885276,1248.26051,1154.1685929999999,21.88527585,22.26050999,31.16859292,108.025248,105.3833605,151.2911843,4512,57.98740522,33.16510454,2760,28.13973166,2328,53.98058252,98.7804878,162.9441624,47.82939832,1884,18.84288747,84.06619385,3556,12.85151856,31.73611111,1371,18.30780452,9.023354565,5.877390326,9.263311451,31629.423280000003,33222515.28,8273.0,8358.0,8301.0,8349.0,8326.0,8345.0,8353.0,8369.0,8350.0,8234.0,8303.0,8322.0,8372.0,8234.0,8086.0,8032.0,7971.0,7921.0,7781.0,7639.0,7443.0,7182.0,6988.0,7089.0,7082.5,7076.0,6789.0,6056.0,4986.0,4638.0,4484.0,4110.0,3837.0,3212.0,3005.0,2787.0,33.22251511,83.88889255,90.45070761,96.68142191,115.49396509999998,123.711284,134.96870980000003,139.60412040000003,150.0789445,182.28601840000002,204.349369,212.9880889,213.1837393,213.3793898,210.33928280000003,216.1786962,224.0348142,229.93442779999998,234.2086376,238.42264730000002,239.9276507,241.7637549,243.3891587,247.84396890000002,251.9977784,250.492775,249.9208736,247.84396890000002,251.33557689999998,251.90747819999996,251.42587709999998,251.1850765,250.61317519999997,251.3054768,249.8606735,251.5763774,249.0178716,0,4,0,1,2,13872.99435,3068.343231,5426.637277000001,2870.998002,1744.336577,33,187,0.00020557599999999998,0,1.0,0.0,1.0,1.0
39009,2391,Cantabria,Cantabria,B√°rcena de Cicero,-3,262,265,71.79966,68.810068,0.0,31.180275,31.180275,7.37277,5.919245,1673.336356,10569.6484,8896.312043,6281.339682,1945.3684879999998,1.430532,4655.135373,4653.704841,1545.619596,1019.68791,26.910749,4251.419261999999,4224.508514,1831.650829,813.3000559999999,17.200435,5005.825985,4988.62555,1896.688177,1028.943021,30.0,22.0,26.0,31.0,31.0,35.0,44,52,47,56,58,49,49,47,37,44,38,34,26,19,30,28.0,25.0,26.0,19.0,28.0,33.0,19,27,34,23,29,31,40,33,32,38,32,27,39,37,45,2,-3,0,12,3,2,25,25,13,33,29,18,9,14,5,6,6,7,-13,-18,-15,201.3422819,159.4202899,198.4732824,246.031746,244.0944882,282.2580645,363.63636360000004,440.67796610000005,398.3050847,482.75862069999994,513.2743363,441.4414414,445.4545455,435.1851852,355.7692308,423.07692310000004,372.54901960000007,333.3333333,252.4271845,197.91666669999998,322.5806452,187.9194631,181.1594203,198.4732824,150.7936508,220.4724409,266.1290323,157.02479340000002,228.81355930000004,288.1355932,198.2758621,256.6371681,279.2792793,363.63636360000004,305.55555560000005,307.6923077,365.3846154,310.6796117,264.7058824,378.6407767,385.4166667,483.8709677,13.42281879,-21.73913043,0,95.23809524,23.62204724,16.12903226,206.6115702,211.86440679999998,110.1694915,284.4827586,256.6371681,162.1621622,81.81818182,129.6296296,48.07692308,57.69230769,58.25242718,68.62745098,-126.21359220000001,-187.5,-161.2903226,237,220,17,290,260,30,-53,-40,-13,261,253,8,279,239,40,-18,14,-32,287,272,15,242,229,13,45,43,2,265,255,10,255,217,38,10,38,-28,280,268,12,265,254,11,15,14,1,312,277,35,266,244,22,46,33,13,352,317,35,284,259,25,68,58,10,354,310,44,265,244,21,89,66,23,335,321,14,238,228,10,97,93,4,164.0,252.0,126.0,220.0,189.0,92.0,263.0,141.0,80.0,208.0,132.0,106.0,186.0,147.0,189.0,177.0,310.0,231.0,193.0,498.0,222.0,276.0,446.0,173.0,489.0,316.0,198.0,460.0,257.0,182.0,399.0,275.0,156.0,272.0,214.0,150.0,296.0,207.0,125.0,214.0,168.0,150.0,198.0,133.0,143.0,152.0,130.0,100.0,111.0,89.0,64.0,78.0,59.0,44.0,35.0,20.0,14.0,8.0,4.0,1.0,0.0,1.0,0.0,91.0,121.0,58.0,113.0,97.0,39.0,125.0,80.0,45.0,113.0,68.0,61.0,91.0,74.0,96.0,91.0,166.0,119.0,98.0,260.0,129.0,137.0,251.0,76.0,245.0,168.0,98.0,248.0,147.0,101.0,225.0,152.0,83.0,145.0,103.0,75.0,153.0,109.0,62.0,103.0,88.0,73.0,105.0,61.0,76.0,73.0,70.0,39.0,48.0,33.0,25.0,34.0,23.0,15.0,12.0,2.0,5.0,2.0,1.0,0.0,0.0,0.0,0.0,73.0,131.0,68.0,107.0,92.0,53.0,138.0,61.0,35.0,95.0,64.0,45.0,95.0,73.0,93.0,86.0,144.0,112.0,95.0,238.0,93.0,139.0,195.0,97.0,244.0,148.0,100.0,212.0,110.0,81.0,174.0,123.0,73.0,127.0,111.0,75.0,143.0,98.0,63.0,111.0,80.0,77.0,93.0,72.0,67.0,79.0,60.0,61.0,63.0,56.0,39.0,44.0,36.0,29.0,23.0,18.0,9.0,6.0,3.0,1.0,0.0,1.0,0.0,11.70463472,14.59378134,14.70788816,283,156,326,284,419,318,233,142,326,298,419,329,582,647,516,604,796,20.26708562,15.14543631,18.095021600000003,100.31471280000001,108.35945659999999,104.89054490000001,1732,2802,2956,68.02827965,70.26078235,67.19709025,327.7921478,603.5560313999999,673.9282815,29.79214781,21.55603141,26.92828146,173.1543624,103.7800687,123.02936629999999,2178,85.54595444,38.03911735,1517,32.23459877,1418,117.9245283,156.81818180000002,142.3076923,45.55468135,579,21.76165803,96.60397074,1849,13.62898864,36.09687937,775,21.16129032,11.74438687,7.084910763,9.419354839,28585.810110000002,36138364.67,4399.0,4319.0,4246.0,4186.0,4132.0,4124.0,4127.0,4080.0,4078.0,4118.0,4074.0,3988.0,3784.0,3613.0,3407.0,3139.0,2935.0,2793.0,2546.0,2490.0,2411.0,2334.0,2252.0,2237.0,2225.0,2213.0,2283.0,2417.0,2698.0,2787.0,3058.0,2799.0,2569.0,2423.0,2138.0,2040.0,36.13836288,56.4497071,59.16150676,67.0478629,71.08789095,77.45231872,84.6192178,77.12026162,74.65750479,66.88183435,63.17386339,61.23686364,61.56892074,61.90097784,62.31604921,64.58510607,66.7158058,68.90184838,70.45144818,77.28629017,81.21563252,86.86060323,94.27654515,99.97685871,104.7086724,110.35364309999999,112.73338570000001,113.9509284,112.84407140000002,112.8994142,114.19997120000001,114.11695690000002,114.3383283,115.83258529999999,117.49287079999999,119.5128848,121.72659879999999,0,1,0,1,3,5606.041536,9863.135025,4378.641505,2565.600976,1828.149032,30,152,0.133270447,0,1.0,1.0,1.0,1.0
39010,2392,Cantabria,Cantabria,B√°rcena de Pie de Concha,271,1274,1003,693.4372490000001,242.511112,0.0,45.702126,45.702126,20.409326,9.622034,11173.29223,16221.09559,5047.803356,13739.391930000002,1164.47893,12.544805,6303.571793,6291.0269880000005,2920.250418,1483.042016,17.277666,5874.182372,5856.904705,2215.288483,1334.728653,13.881651000000002,6146.139404,6132.257753,3275.147509,1282.892972,1.0,1.0,6.0,4.0,3.0,9.0,0,5,5,2,3,1,5,4,3,4,2,4,6,2,1,6.0,8.0,21.0,10.0,11.0,10.0,15,14,5,6,11,14,13,17,6,6,6,7,7,9,10,-5,-7,-15,-6,-8,-1,-15,-9,0,-4,-8,-13,-8,-13,-3,-2,-4,-3,-1,-7,-9,6.097560976,6.369426752,37.03703704,25.3164557,19.60784314,61.2244898,0.0,34.01360544,30.303030300000003,11.11111111,17.24137931,5.291005291,27.17391304,21.73913043,17.14285714,22.47191011,12.12121212,24.24242424,38.46153846,13.42281879,6.896551724,36.58536585,50.95541401,129.6296296,63.29113924,71.89542484,68.02721088,108.69565220000001,95.23809524,30.303030300000003,33.33333333,63.218390799999995,74.07407407,70.65217391,92.39130435,34.28571429,33.70786517,35.087719299999996,42.42424242,44.87179487,60.40268456,68.96551724,-30.48780488,-44.58598726,-92.59259259,-37.97468354,-52.2875817,-6.802721088,-108.69565220000001,-61.22448979999999,0.0,-22.22222222,-45.97701149,-68.78306878,-43.47826087,-70.65217391,-17.14285714,-11.23595506,-23.39181287,-18.18181818,-6.41025641,-46.97986577,-62.06896552,15,15,0,28,24,4,-13,-9,-4,25,25,0,13,13,0,12,12,0,31,30,1,32,32,0,-1,-2,1,16,16,0,28,28,0,-12,-12,0,15,15,0,38,38,0,-23,-23,0,19,18,1,24,24,0,-5,-6,1,36,33,3,37,37,0,-1,-4,3,26,26,0,27,26,1,-1,0,-1,24,23,1,17,17,0,7,6,1,13.0,25.0,16.0,13.0,16.0,24.0,17.0,25.0,36.0,20.0,28.0,45.0,21.0,47.0,55.0,31.0,49.0,60.0,31.0,49.0,54.0,43.0,58.0,52.0,44.0,50.0,69.0,45.0,59.0,75.0,48.0,70.0,49.0,55.0,65.0,46.0,69.0,47.0,32.0,61.0,33.0,41.0,46.0,38.0,66.0,34.0,49.0,42.0,30.0,39.0,30.0,28.0,25.0,24.0,18.0,9.0,6.0,4.0,6.0,2.0,0.0,1.0,1.0,9.0,14.0,7.0,5.0,10.0,17.0,10.0,14.0,17.0,12.0,18.0,27.0,14.0,26.0,25.0,19.0,31.0,35.0,17.0,25.0,32.0,29.0,26.0,23.0,18.0,26.0,35.0,24.0,26.0,42.0,24.0,35.0,23.0,25.0,35.0,22.0,32.0,22.0,12.0,34.0,12.0,18.0,22.0,18.0,30.0,14.0,21.0,20.0,10.0,19.0,12.0,12.0,9.0,8.0,7.0,3.0,3.0,0.0,1.0,0.0,0.0,0.0,0.0,4.0,11.0,9.0,8.0,6.0,7.0,7.0,11.0,19.0,8.0,10.0,18.0,7.0,21.0,30.0,12.0,18.0,25.0,14.0,24.0,22.0,14.0,32.0,29.0,26.0,24.0,34.0,21.0,33.0,33.0,24.0,35.0,26.0,30.0,30.0,24.0,37.0,25.0,20.0,27.0,21.0,23.0,24.0,20.0,36.0,20.0,28.0,22.0,20.0,20.0,18.0,16.0,16.0,16.0,11.0,6.0,3.0,4.0,5.0,2.0,0.0,1.0,1.0,9.212121212000001,8.375634518,6.408345753,121,35,117,28,122,19,91,41,117,38,122,24,66,43,212,200,221,25.696969699999997,25.38071066,32.93591654,97.84172662,98.48866499,100.8982036,537,522,407,65.09090909,66.24365482,60.655737699999996,115.47858470000001,104.3141762,97.29975429999999,39.47858473,38.31417625,54.2997543,278.9473684,303.030303,513.9534884,668,80.96969697,27.41116751,216,24.29210134,163,71.11111111,167.8571429,345.0,42.44604317,177,9.039548023,70.78085642,281,8.896797153,32.63473054,109,11.926605499999999,5.084745763,3.914590747,3.6697247710000003,31919.248910000002,30528254.78,671.0,672.0,678.0,680.0,687.0,710.0,728.0,735.0,739.0,758.0,770.0,788.0,805.0,787.0,794.0,800.0,805.0,811.0,825.0,885.0,902.0,922.0,941.0,932.0,943.5,955.0,952.0,920.0,1012.0,1137.0,1112.0,1102.0,1107.0,1235.0,1200.0,1091.0,30.52825546,35.73738438,39.30784717,40.45432604,36.26148901,36.09770632,36.42527171,37.24418519,33.14961778,30.13601616,31.18422542,31.28249504,30.90579484,30.52909463,30.82390349,30.20152924,29.54639845,28.98953729,27.02414493,26.56555338,26.36901414,26.20523144,26.00869221,25.77939643,26.36901414,25.81215297,25.22253527,24.82945679,24.20708255,24.07605639,23.84676061,23.25714291,22.503742499999998,22.27444673,22.20893365,22.01239441,21.97963787,0,0,0,0,2,27678.183080000003,6588.072185,12375.51198,12866.13978,2159.2821519999998,9,54,0.018772751,0,1.0,0.11,1.0,1.0
39011,2393,Cantabria,Cantabria,Bareyo,-1,274,275,77.110571,52.83334,0.0,36.535297,36.535297,6.891147,4.937064,10856.35601,14968.27645,4111.920434000001,13252.45578,761.844557,2499.4302399999997,11048.929259999999,8549.499020000001,7061.386561,2050.087334,2861.036959,11323.7651,8462.728137,7334.224543,2089.066134,3452.475204,11129.68693,7677.211725,7425.510187000001,1880.2919219999999,6.0,16.0,13.0,12.0,15.0,14.0,20,9,24,21,18,26,20,20,11,13,14,13,10,11,21,14.0,25.0,13.0,21.0,18.0,22.0,17,19,21,27,27,28,31,22,19,19,22,23,23,13,19,-8,-9,0,-9,-3,-8,3,-10,3,-6,-9,-2,-11,-2,-8,-6,-8,-10,-13,-2,2,11.36363636,31.49606299,25.74257426,23.25581395,30.48780488,29.35010482,43.85964912,19.18976546,53.81165919,48.95104895,41.28440367,59.9078341,47.16981132,49.14004914,27.84810127,32.66331658,36.5535248,33.94255875,27.39726027,30.81232493,17.24137931,26.51515152,49.21259843,25.74257426,40.69767442,36.58536585,46.12159329,37.28070175,40.51172708,47.08520179,62.93706294,61.92660550000001,64.51612903,73.11320755,54.05405405,48.10126582,47.73869347,56.84754522,60.05221932,63.01369863,36.41456583,54.59770115,-15.15151515,-17.71653543,0,-17.44186047,-6.097560976,-16.77148847,6.578947368,-21.32196162,6.726457399,-13.98601399,-20.64220183,-4.6082949310000005,-25.94339623,-4.9140049139999995,-20.25316456,-15.07537688,-20.67183463,-26.10966057,-35.61643836,-5.6022408960000005,5.747126437,83,74,9,107,104,3,-24,-30,6,99,94,5,101,97,4,-2,-3,1,104,99,5,98,96,2,6,3,3,90,84,6,90,86,4,0,-2,2,93,76,17,91,88,3,2,-12,14,101,89,12,105,100,5,-4,-11,7,104,92,12,105,102,3,-1,-10,9,126,108,18,84,79,5,42,29,13,229,209,20,88,87,1,141,122,19,87.0,96.0,58.0,102.0,73.0,63.0,105.0,75.0,97.0,80.0,111.0,94.0,73.0,125.0,104.0,93.0,132.0,109.0,126.0,154.0,131.0,161.0,173.0,152.0,174.0,183.0,126.0,176.0,157.0,117.0,183.0,163.0,94.0,148.0,127.0,91.0,164.0,99.0,90.0,145.0,76.0,105.0,113.0,88.0,88.0,69.0,88.0,97.0,63.0,67.0,55.0,38.0,51.0,24.0,18.0,9.0,7.0,10.0,6.0,0.0,1.0,0.0,0.0,47.0,56.0,31.0,50.0,29.0,36.0,53.0,46.0,51.0,28.0,63.0,50.0,49.0,62.0,55.0,54.0,72.0,55.0,59.0,69.0,64.0,87.0,81.0,80.0,80.0,104.0,61.0,94.0,73.0,73.0,90.0,98.0,47.0,72.0,68.0,41.0,90.0,50.0,51.0,79.0,34.0,55.0,60.0,47.0,37.0,26.0,41.0,46.0,36.0,27.0,22.0,14.0,15.0,12.0,5.0,0.0,1.0,2.0,1.0,0.0,0.0,0.0,0.0,40.0,40.0,27.0,52.0,44.0,27.0,52.0,29.0,46.0,52.0,48.0,44.0,24.0,63.0,49.0,39.0,60.0,54.0,67.0,85.0,67.0,74.0,92.0,72.0,94.0,79.0,65.0,82.0,84.0,44.0,93.0,65.0,47.0,76.0,59.0,50.0,74.0,49.0,39.0,66.0,42.0,50.0,53.0,41.0,51.0,43.0,47.0,51.0,27.0,40.0,33.0,24.0,36.0,12.0,13.0,9.0,6.0,8.0,5.0,0.0,1.0,0.0,0.0,12.80846063,11.88504627,13.80930014,203,100,220,113,235,144,173,118,220,131,235,150,244,294,376,385,457,22.09165687,18.75304433,21.46547675,104.0767386,101.8682399,101.9924099,1108,1424,1378,65.09988249,69.3619094,64.72522311,251.93501809999998,271.0365169,327.16400580000004,33.93501805,27.03651685,33.16400581,172.4770642,157.7868852,155.44217690000002,292,17.15628672,32.48904043,667,29.92015031,637,95.74468085,89.18918919,205.0,43.76498801,365,15.89041096,86.33235005,878,10.93394077,33.87096774,357,24.3697479,7.397260274,4.555808656,11.20448179,29842.1489,32260845.92,2129.0,1994.0,1950.0,1972.0,1987.0,1999.0,2011.0,2016.0,2021.0,2060.0,2075.0,2053.0,2060.0,2003.0,1928.0,1895.0,1883.0,1810.0,1702.0,1690.0,1730.0,1708.0,1714.0,1654.0,1679.0,1704.0,1576.0,1642.0,1758.0,2118.0,2299.0,2100.0,1789.0,1512.0,1299.0,1184.0,32.26084518,36.70083636,40.26552908,46.86795995,55.45421981,65.09438882,71.26285709,65.65234072,54.49330264,50.89761259,48.85178894,52.81944693,52.04451373,51.26958053,53.12942021,52.94343624,53.62537745,52.38548433,52.75745227,56.10516369,58.36796864,58.73993658,59.762848399999996,62.087648,63.85449570000001,63.6375144,64.31945562,63.85449570000001,62.64559989999999,62.49061326,62.33562662,61.96365869,61.59169075,61.12673083,60.44478962,61.80867205,65.99331133,0,0,0,0,1,13734.68981,3139.172344,5680.815259,4085.10687,2226.9398850000002,56,332,0.103324514,0,0.99,0.15,1.0,1.0
39033,2394,Cantabria,Cantabria,Herrer√≠as,24,614,590,249.164854,134.969225,0.122584,41.58485,41.462266,12.604351,6.555614,30340.571010000003,39059.21982,8718.648811,35138.74839,2250.016474,1030.939594,8967.000504000001,7936.060909999999,5407.861405,1736.433533,3834.4760539999997,10401.87766,6567.401604,6689.318969,1526.0925439999999,3912.704315,10462.724890000001,6550.020570000001,6817.287777,1495.833317,0.0,1.0,3.0,2.0,4.0,5.0,1,2,3,2,3,2,1,4,6,4,2,3,3,2,0,9.0,13.0,11.0,11.0,4.0,10.0,12,16,7,8,8,11,8,8,8,8,8,8,12,11,8,-9,-12,-8,-9,0,-5,-11,-14,-4,-6,-5,-9,-7,-4,-2,-4,-6,-5,-9,-9,-8,0,5.405405405,16.21621622,10.75268817,21.62162162,27.32240437,5.3763440860000005,10.30927835,16.30434783,11.36363636,17.24137931,11.9047619,5.882352941000001,25.0,39.21568627,25.80645161,13.15789474,19.73684211,20.54794521,13.88888889,0.0,46.875,70.27027027,59.45945946,59.13978495,21.62162162,54.64480874,64.51612903,82.4742268,38.04347826,45.45454545,45.97701149,65.47619048,47.05882353,50.0,52.287581700000004,51.61290323,54.05405405,52.63157895,82.19178082,76.38888889,54.05405405,-46.875,-64.86486486,-43.24324324,-48.38709677,0,-27.32240437,-59.13978495,-72.16494845,-21.73913043,-34.09090909,-28.73563218,-53.57142857,-41.17647059,-25.0,-13.07189542,-25.80645161,-40.54054054,-32.89473684,-61.64383562,-62.5,-54.05405405,23,23,0,14,14,0,9,9,0,25,24,1,25,25,0,0,-1,1,30,28,2,23,23,0,7,5,2,11,10,1,19,18,1,-8,-8,0,21,21,0,35,35,0,-14,-14,0,18,16,2,25,25,0,-7,-9,2,29,25,4,26,25,1,3,0,3,15,15,0,24,24,0,-9,-9,0,34,25,9,24,23,1,10,2,8,8.0,13.0,7.0,13.0,11.0,11.0,12.0,6.0,24.0,20.0,19.0,29.0,14.0,22.0,54.0,20.0,38.0,50.0,17.0,48.0,39.0,38.0,45.0,49.0,34.0,48.0,47.0,45.0,39.0,48.0,46.0,52.0,56.0,48.0,47.0,45.0,56.0,55.0,62.0,47.0,53.0,56.0,57.0,46.0,49.0,50.0,47.0,46.0,31.0,37.0,25.0,22.0,13.0,19.0,9.0,7.0,12.0,2.0,2.0,3.0,0.0,1.0,0.0,5.0,6.0,3.0,8.0,6.0,4.0,7.0,3.0,15.0,11.0,14.0,15.0,7.0,11.0,30.0,14.0,20.0,33.0,10.0,24.0,22.0,19.0,31.0,35.0,17.0,27.0,32.0,29.0,32.0,31.0,27.0,31.0,31.0,29.0,24.0,27.0,37.0,32.0,35.0,22.0,29.0,34.0,32.0,24.0,26.0,24.0,26.0,20.0,18.0,15.0,12.0,9.0,5.0,7.0,3.0,3.0,3.0,0.0,1.0,0.0,0.0,0.0,0.0,3.0,7.0,4.0,5.0,5.0,7.0,5.0,3.0,9.0,9.0,5.0,14.0,7.0,11.0,24.0,6.0,18.0,17.0,7.0,24.0,17.0,19.0,14.0,14.0,17.0,21.0,15.0,16.0,7.0,17.0,19.0,21.0,25.0,19.0,23.0,18.0,19.0,23.0,27.0,25.0,24.0,22.0,25.0,22.0,23.0,26.0,21.0,26.0,13.0,22.0,13.0,13.0,8.0,12.0,6.0,4.0,9.0,2.0,1.0,3.0,0.0,1.0,0.0,5.745554036000001,4.622496148,5.602716469,108,20,103,15,110,13,102,22,103,15,110,20,30,33,210,206,218,28.72777018,31.74114022,37.01188455,131.3291139,127.71929820000001,125.67049809999999,479,413,338,65.52667579,63.63636364,57.38539898,85.84133612,79.87893462,97.49704142,43.84133612,49.87893462,64.49704142,500.0,686.6666667000001,660.6060606000001,457,62.51709986,27.73497689,180,22.75042445,134,213.7931034,289.4736842,280.0,52.84810127,167,4.191616766,77.19298246,220,5.909090909,29.88505747,78,10.25641026,2.395209581,3.1818181819999998,3.8461538460000004,27047.92222,40210677.78,589.0,587.0,605.0,609.0,623.0,641.0,657.0,648.0,652.0,639.0,641.0,649.0,652.0,669.0,685.0,700.0,715.0,720.0,731.0,742.0,773.0,786.0,798.0,744.0,749.0,754.0,798.0,885.0,1227.0,1471.0,1598.0,1447.0,1356.0,1322.0,1367.0,1254.0,40.2106781,31.18574616,33.99594497,32.87683925,33.7223858,35.98546626,39.74068769,36.58232264,30.51428272,22.00907922,19.84547483,18.75123812,18.62689304,18.50254796,19.84547483,19.54704663,19.22374942,18.45280993,18.17925075,17.90569157,17.78134649,17.40831125,17.03527601,16.63737175,16.21459848,16.13999143,15.941039300000002,15.89130127,16.21459848,16.11512242,16.33894356,15.941039300000002,15.49339701,15.14523079,15.04575472,14.59811244,14.64785047,0,0,0,0,1,33005.6051,5758.33207,7011.356156999999,7904.3009870000005,2625.827307,14,75,0.000582194,0,1.0,0.0,0.99,1.0
39013,2395,Cantabria,Cantabria,Cabez√≥n de Li√©bana,285,1972,1687,881.596143,318.04082200000005,0.122584,44.892879,44.770295000000004,21.503751,7.705483999999999,29248.3842,42285.0658,13036.6816,35722.20448,2957.216711,989.4383210000001,13134.42721,12144.98889,6782.855385,2861.057517,22191.63738,33332.1756,11140.53822,27193.83225,2372.503671,21840.16071,30739.7068,8899.54609,26451.12011,2154.113849,5.0,8.0,6.0,1.0,5.0,2.0,6,1,3,6,1,6,1,2,2,3,0,4,3,0,3,6.0,7.0,15.0,17.0,15.0,12.0,11,15,10,8,6,9,17,8,15,11,7,9,10,11,6,-1,1,-9,-16,-10,-10,-5,-14,-7,-2,-5,-3,-16,-6,-13,-8,-7,-5,-7,-11,-3,23.69668246,38.27751196,30,5.128205128,24.75247525,9.478672986,28.30188679,4.784688995,14.49275362,29.26829268,4.95049505,28.84615385,4.854368932,10.0,10.47120419,15.54404145,0.0,20.40816327,16.21621622,0.0,28.57142857,28.43601896,33.49282297,75,87.17948718,74.25742574,56.87203791,51.88679245,71.77033493,48.30917874,39.02439024,29.702970299999997,43.26923077,82.52427184,40.0,78.53403141,56.99481865,37.23404255,45.91836735,54.05405405,60.10928962,34.28571429,-4.739336493,4.784688995,-45,-82.05128205,-49.5049505,-47.39336493,-23.58490566,-66.98564593,-33.81642512,-9.756097561,-24.75247525,-14.42307692,-77.66990291,-30.0,-68.06282723,-41.450777200000005,-37.23404255,-25.51020408,-37.83783784,-60.10928962,-17.14285714,26,24,2,42,42,0,-16,-18,2,22,21,1,62,35,27,-40,-14,-26,42,42,0,35,28,7,7,14,-7,16,13,3,32,28,4,-16,-15,-1,30,30,0,30,26,4,0,4,-4,32,31,1,27,25,2,5,6,-1,68,67,1,35,33,2,33,34,-1,56,50,6,57,57,0,-1,-7,6,28,20,8,59,48,11,-31,-28,-3,14.0,21.0,25.0,15.0,30.0,10.0,19.0,10.0,10.0,21.0,14.0,28.0,14.0,21.0,36.0,20.0,41.0,38.0,24.0,35.0,54.0,33.0,61.0,50.0,43.0,59.0,44.0,35.0,55.0,42.0,54.0,48.0,47.0,52.0,42.0,46.0,46.0,51.0,43.0,50.0,47.0,55.0,44.0,43.0,38.0,35.0,42.0,51.0,32.0,22.0,51.0,20.0,35.0,18.0,5.0,8.0,17.0,3.0,4.0,4.0,1.0,1.0,1.0,8.0,14.0,16.0,9.0,16.0,6.0,11.0,7.0,8.0,12.0,9.0,14.0,9.0,11.0,17.0,12.0,21.0,20.0,13.0,23.0,33.0,15.0,43.0,32.0,28.0,42.0,29.0,17.0,39.0,26.0,29.0,32.0,31.0,33.0,26.0,33.0,26.0,30.0,24.0,29.0,31.0,27.0,29.0,22.0,18.0,24.0,20.0,28.0,12.0,14.0,18.0,8.0,10.0,6.0,2.0,2.0,6.0,2.0,2.0,1.0,0.0,1.0,0.0,6.0,7.0,9.0,6.0,14.0,4.0,8.0,3.0,2.0,9.0,5.0,14.0,5.0,10.0,19.0,8.0,20.0,18.0,11.0,12.0,21.0,18.0,18.0,18.0,15.0,17.0,15.0,18.0,16.0,16.0,25.0,16.0,16.0,19.0,16.0,13.0,20.0,21.0,19.0,21.0,16.0,28.0,15.0,21.0,20.0,11.0,22.0,23.0,20.0,8.0,33.0,12.0,25.0,12.0,3.0,6.0,11.0,1.0,2.0,3.0,1.0,0.0,1.0,6.355932202999999,8.84057971,8.275862069,131,15,100,24,84,20,104,30,100,37,84,28,61,48,235,202,190,33.1920904,29.27536232,32.75862069,124.7619048,150.9090909,130.1587302,428,427,342,60.4519774,61.88405797,58.96551724,99.90654206,108.3067916,103.5555556,54.90654206,47.30679157,55.55555556,522.2222222,331.147541,395.8333333,177,25.0,30.43478261,210,23.27586207,135,153.5714286,364.2857143,219.047619,46.03174603,145,17.24137931,84.0,231,9.090909091,35.31746032,89,15.73033708,6.206896552000001,3.03030303,6.741573034,44398.58777,81402356.55,580.0,604.0,616.0,592.0,595.0,601.0,622.0,628.0,650.0,707.0,699.0,690.0,699.0,685.0,688.0,686.0,700.0,705.0,708.0,727.0,718.0,679.0,702.0,732.0,757.0,782.0,810.0,953.0,1361.0,1892.0,2209.0,2152.0,2121.0,2190.0,2207.0,2199.0,81.40235901,27.01395914,27.11223639,26.90339723,26.05575595,26.43658029,27.136805699999996,23.24256966,16.71941718,11.70727743,9.950571579,9.606601203,9.299484796,8.99236839,8.623828702,8.341281607,8.820383202,8.930945108,8.697536638999999,8.66068267,8.599259389,8.427274201,8.451843514,8.414989545,8.586974733,8.476412826,8.586974733,8.685251982999999,7.985026576,7.714764138,7.6410562,7.383078417999999,7.309370481,7.272516512,7.567348262,7.419932387,7.125100637,0,0,0,0,1,45725.90349,5462.327842000001,7641.743223,5748.735693,3862.8803270000003,27,137,5.352617823,0,0.0,0.0,1.0,0.0
39014,2396,Cantabria,Cantabria,Cabu√©rniga,188,1165,977,569.470968,197.514399,0.122584,40.637440000000005,40.514855,17.625076,7.60422,20037.461,29453.000969999997,9415.539964,24427.674030000002,1960.9162039999999,5539.608667,20082.25648,14542.647819999998,11778.93439,3212.3863260000003,6434.554311,20443.65716,14009.10285,12296.091999999999,3068.833312,5329.222465999999,20122.64319,14793.420719999998,11836.55045,3275.786811,8.0,7.0,6.0,2.0,9.0,7.0,10,5,4,1,7,6,1,6,2,8,4,3,2,3,4,18.0,17.0,17.0,24.0,23.0,18.0,23,25,17,13,20,19,16,26,23,19,10,14,15,27,14,-10,-10,-11,-22,-14,-11,-13,-20,-13,-12,-13,-13,-15,-20,-21,-11,-6,-11,-13,-24,-10,4.898958971,4.326328801,3.683241252,1.214329083,5.47112462,4.2527339,6.11995104,3.111387679,2.486016159,0.6321112520000001,4.487179487,3.8560411310000005,0.647249191,3.94218134,1.341381623,5.401755571,2.822865208,2.1171489059999997,1.427551749,2.166064982,5.8436815189999995,11.02265769,10.50679852,10.43585021,14.571949,13.98176292,10.93560146,14.07588739,15.55693839,10.56556868,8.217446271,12.82051282,12.21079692,10.35598706,17.08278581,15.42588867,12.82916948,6.877579092,9.880028229,10.70663812,19.49458484,10.22644266,-6.123698714,-6.180469716,-6.752608963,-13.35761991,-8.510638298,-6.682867558,-7.955936352999999,-12.44555072,-8.079552517,-7.5853350189999995,-8.333333332999999,-8.354755784,-9.708737864,-13.14060447,-14.08450704,-7.42741391,-4.126547455,-7.762879323,-9.279086367,-17.32851986,-7.304601899,22,22,0,29,29,0,-7,-7,0,32,31,1,37,36,1,-5,-5,0,32,32,0,32,32,0,0,0,0,64,62,2,31,30,1,33,32,1,34,33,1,30,30,0,4,3,1,43,43,0,32,30,2,11,13,-2,55,54,1,38,38,0,17,16,1,42,37,5,51,51,0,-9,-14,5,56,47,9,17,15,2,39,32,7,12.0,30.0,33.0,30.0,24.0,36.0,28.0,29.0,37.0,25.0,35.0,46.0,39.0,51.0,59.0,31.0,56.0,87.0,49.0,72.0,83.0,60.0,85.0,83.0,76.0,89.0,60.0,77.0,77.0,66.0,87.0,63.0,69.0,75.0,82.0,77.0,71.0,63.0,58.0,72.0,79.0,89.0,62.0,73.0,81.0,64.0,62.0,50.0,52.0,57.0,40.0,47.0,41.0,30.0,23.0,10.0,19.0,4.0,6.0,6.0,1.0,2.0,0.0,3.0,17.0,18.0,17.0,14.0,21.0,14.0,18.0,19.0,17.0,17.0,21.0,21.0,27.0,32.0,18.0,27.0,51.0,31.0,40.0,47.0,33.0,51.0,46.0,43.0,51.0,37.0,44.0,44.0,41.0,51.0,38.0,36.0,45.0,50.0,38.0,42.0,30.0,29.0,38.0,40.0,45.0,28.0,39.0,42.0,28.0,24.0,25.0,24.0,22.0,15.0,17.0,17.0,3.0,7.0,1.0,2.0,2.0,0.0,0.0,0.0,0.0,0.0,9.0,13.0,15.0,13.0,10.0,15.0,14.0,11.0,18.0,8.0,18.0,25.0,18.0,24.0,27.0,13.0,29.0,36.0,18.0,32.0,36.0,27.0,34.0,37.0,33.0,38.0,23.0,33.0,33.0,25.0,36.0,25.0,33.0,30.0,32.0,39.0,29.0,33.0,29.0,34.0,39.0,44.0,34.0,34.0,39.0,36.0,38.0,25.0,28.0,35.0,25.0,30.0,24.0,27.0,16.0,9.0,17.0,2.0,6.0,6.0,1.0,2.0,0.0,9.558160505,7.642725598999999,7.106598985,183,48,187,34,181,36,132,58,187,49,181,34,83,70,315,330,325,28.40396754,30.38674033,32.99492386,104.99075790000002,109.24855490000002,113.2034632,688,673,590,62.03787196,61.97053407,59.89847716,151.7848837,132.03417530000002,125.0847458,45.78488372,49.03417533,55.08474576,297.1698113,397.59036139999995,464.2857143,214,19.29666366,29.74217311,323,26.59898477,262,126.0869565,180.0,284.0,43.25323475,234,14.1025641,74.75915222,388,7.731958763,35.28138528,163,7.36196319,6.41025641,3.350515464,5.521472393,56197.0798,85667728.73,985.0,965.0,1000.0,999.0,1001.0,1012.0,998.0,1016.0,1046.0,1066.0,1077.0,1086.0,1093.0,1083.0,1093.0,1096.0,1112.0,1134.0,1109.0,1114.0,1110.0,1083.0,1110.0,1119.0,1135.5,1152.0,1091.0,1137.0,1486.0,1837.0,1811.0,1745.0,1879.0,2095.0,1997.0,2262.0,85.66773224,26.40434083,23.31099409,24.45494873,21.93357932,20.36939644,21.13981487,21.44331304,17.34608774,13.27220845,12.73525015,13.44730355,13.25469894,13.06209434,12.95703728,12.6418661,12.95703728,13.0037293,12.94536427,13.23718943,12.98038329,12.79361518,12.75859616,12.6418661,12.75859616,12.67688512,12.57182806,12.44342499,12.20996486,11.85977466,11.64966054,11.81308263,11.68467956,11.66133355,11.67300656,11.26445133,11.49791146,0,1,0,0,2,25299.450409999998,1964.2566829999998,12002.20262,11304.163279999999,2675.3304780000003,19,131,0.000577271,0,0.0,0.0,1.0,1.0
39048,2397,Cantabria,Cantabria,Penagos,90,644,554,209.78871400000003,118.278908,0.0,33.465115000000004,33.465115000000004,8.485828999999999,6.129933,3375.204062,11942.055129999999,8566.851063,7734.633345,2105.881034,8.458205,5255.934924,5247.476718999999,2015.384184,1250.566084,43.850561,5747.754063,5703.903502,2489.309644,1182.548576,2637.08857,7843.0674819999995,5205.978912,5466.822609000001,1129.216882,11.0,14.0,12.0,11.0,9.0,11.0,12,11,15,11,13,14,24,11,22,21,13,25,13,17,21,25.0,17.0,26.0,28.0,18.0,16.0,22,17,15,19,17,14,16,15,20,13,23,24,14,15,26,-14,-3,-14,-17,-9,-5,-10,-6,0,-8,-4,0,8,-4,2,8,-10,1,-1,2,-5,34.05572755,43.88714734,39.08794788,36.42384106,30.3030303,38.06228374,42.55319149,38.32752613,54.94505495,41.66666667,48.32713755,51.66051661,89.88764045,40.89219331,84.61538462,81.71206226,53.71900826,103.3057851,55.79399142,74.88986784,50.458715600000005,77.3993808,53.29153605,84.69055375,92.71523179,60.60606061,55.3633218,78.0141844,59.23344948,54.94505495,71.96969697,63.19702602,51.66051661,59.92509363,55.76208178,76.92307692,50.58365759,93.49593496,99.17355372,60.08583691,66.07929515,119.26605500000001,-43.34365325,-9.404388715,-45.60260586,-56.29139073,-30.3030303,-17.30103806,-35.46099291,-20.90592334,0.0,-30.303030300000003,-14.86988848,0.0,29.96254682,-14.86988848,7.692307692000001,31.12840467,-40.6504065,4.132231405,-4.2918454939999995,8.810572687,-22.93577982,147,146,1,73,63,10,74,83,-9,69,66,3,87,85,2,-18,-19,1,109,108,1,87,87,0,22,21,1,119,116,3,79,77,2,40,39,1,99,95,4,65,62,3,34,33,1,102,97,5,79,78,1,23,19,4,132,126,6,95,92,3,37,34,3,107,95,12,99,96,3,8,-1,9,129,127,2,99,99,0,30,28,2,93.0,68.0,70.0,113.0,72.0,58.0,107.0,65.0,72.0,73.0,75.0,75.0,81.0,70.0,105.0,91.0,131.0,135.0,128.0,151.0,138.0,178.0,158.0,154.0,200.0,155.0,134.0,182.0,172.0,90.0,177.0,122.0,85.0,190.0,93.0,113.0,136.0,90.0,93.0,100.0,108.0,108.0,67.0,84.0,113.0,84.0,113.0,75.0,62.0,61.0,48.0,74.0,35.0,29.0,22.0,9.0,12.0,10.0,1.0,3.0,0.0,0.0,0.0,44.0,37.0,37.0,63.0,36.0,35.0,55.0,30.0,35.0,40.0,38.0,43.0,35.0,41.0,47.0,46.0,72.0,70.0,69.0,81.0,71.0,85.0,83.0,81.0,114.0,81.0,77.0,107.0,91.0,41.0,85.0,65.0,44.0,91.0,47.0,50.0,78.0,36.0,50.0,50.0,57.0,49.0,29.0,36.0,62.0,38.0,62.0,32.0,22.0,26.0,19.0,36.0,8.0,11.0,5.0,4.0,3.0,4.0,0.0,0.0,0.0,0.0,0.0,49.0,31.0,33.0,50.0,36.0,23.0,52.0,35.0,37.0,33.0,37.0,32.0,46.0,29.0,58.0,45.0,59.0,65.0,59.0,70.0,67.0,93.0,75.0,73.0,86.0,74.0,57.0,75.0,81.0,49.0,92.0,57.0,41.0,99.0,46.0,63.0,58.0,54.0,43.0,50.0,51.0,59.0,38.0,48.0,51.0,46.0,51.0,43.0,40.0,35.0,29.0,38.0,27.0,18.0,17.0,5.0,9.0,6.0,1.0,3.0,0.0,0.0,0.0,11.69590643,11.18385161,14.43726937,212,93,218,102,235,151,176,107,218,103,235,162,205,313,388,411,419,22.69005848,22.42225859,19.32656827,100.46893320000001,103.2150776,102.23880600000001,1122,1217,1436,65.61403509,66.3938898,66.23616236,234.58110519999997,238.7715694,342.178273,34.58110517,33.77156943,29.17827298,194.0,200.48780490000001,133.86581470000002,316,18.47953216,34.69721768,636,31.73431734,688,124.0,120.0,186.3013699,45.60375147,389,17.99485861,82.03991131,740,9.189189189,36.28731343,389,23.90745501,8.483290488,4.1891891889999995,12.59640103,24699.24609,31665995.04,2168.0,2142.0,2142.0,2108.0,2083.0,2060.0,2017.0,1997.0,2020.0,1929.0,1878.0,1833.0,1803.0,1766.0,1719.0,1679.0,1698.0,1707.0,1710.0,1750.0,1702.0,1633.0,1635.0,1635.0,1665.5,1696.0,1823.0,1953.0,2059.0,2191.0,2352.0,2563.0,2650.0,2565.0,1974.0,1746.0,31.66599464,55.13801223,62.33816503,81.001719,83.68598649,80.93855976,74.27526046,69.19094204,65.02243252,61.67499306,57.56964278,53.55903135,52.59585302,51.63267468,51.63267468,51.56951545,53.74850906,55.2643307,54.001146,53.90640715,53.62219059,53.02217786,54.28536256,55.76960458,56.93805043,57.88543896,59.30652175,60.91708224,63.79082744,63.06449623,63.69608859,65.05401214,65.78034334,66.56983378,67.64354078,67.64354078,68.46461083,0,1,0,0,1,13833.39039,2373.148754,4082.2811560000005,3615.291861,2189.227455,14,84,0.0026858809999999998,0,0.95,0.62,1.0,1.0
39015,2398,Cantabria,Cantabria,Camale√±o,312,2597,2285,1257.1832220000001,482.98957800000005,0.17336,61.002148,60.828787,23.568804,10.067395,43660.99028,61072.925970000004,17411.935690000002,52182.10557,3882.7277259999996,544.075544,14039.994630000001,13495.919090000001,6337.886028,2929.450089,22294.580280000002,36694.61214,14400.03186,29071.245039999998,3343.518313,20608.09186,33542.69262,12934.60076,27820.7493,2999.2926199999997,6.0,7.0,3.0,14.0,9.0,4.0,11,9,3,4,6,4,6,2,4,5,2,2,5,2,5,8.0,26.0,15.0,14.0,13.0,22.0,13,14,20,13,12,16,20,15,14,22,17,15,10,13,11,-2,-19,-12,0,-4,-18,-2,-5,-17,-9,-6,-12,-14,-13,-10,-17,-15,-13,-5,-11,-6,32.78688525,38.25136612,16.66666667,83.83233533,53.57142857,23.66863905,65.0887574,54.21686747,18.75,26.49006623,39.73509934,25.157232699999998,38.70967742,13.98601399,29.19708029,40.0,15.625,15.625,37.59398496,15.625,49.18032787,43.71584699,142.0765027,83.33333333,83.83233533,77.38095238,130.1775148,76.92307692,84.33734940000001,125.0,86.09271523,79.47019868,100.62893079999999,129.0322581,104.8951049,102.18978100000001,176.0,136.0,117.1875,75.18796992,101.5625,90.16393443,-10.92896175,-103.8251366,-66.66666667,0,-23.80952381,-106.5088757,-11.83431953,-30.12048193,-106.25,-59.60264901,-39.73509934,-75.47169811,-90.32258065,-90.90909091,-72.99270073,-136.0,-120.0,-101.5625,-37.59398496,-85.9375,-49.18032787,25,17,8,38,38,0,-13,-21,8,29,25,4,18,17,1,11,8,3,86,78,8,66,57,9,20,21,-1,46,33,13,60,57,3,-14,-24,10,54,43,11,53,50,3,1,-7,8,37,29,8,45,42,3,-8,-13,5,47,44,3,57,49,8,-10,-5,-5,54,46,8,51,48,3,3,-2,5,65,61,4,32,30,2,33,31,2,18.0,26.0,36.0,26.0,35.0,35.0,28.0,37.0,34.0,37.0,36.0,47.0,41.0,51.0,48.0,46.0,52.0,54.0,48.0,57.0,78.0,58.0,61.0,94.0,54.0,76.0,90.0,70.0,101.0,63.0,74.0,83.0,61.0,95.0,65.0,61.0,92.0,71.0,49.0,69.0,53.0,70.0,59.0,58.0,93.0,53.0,75.0,80.0,34.0,54.0,53.0,37.0,39.0,34.0,16.0,16.0,13.0,1.0,4.0,2.0,0.0,0.0,1.0,8.0,16.0,15.0,18.0,14.0,21.0,17.0,18.0,18.0,17.0,25.0,23.0,20.0,20.0,28.0,30.0,32.0,33.0,15.0,30.0,37.0,33.0,34.0,58.0,32.0,40.0,50.0,36.0,63.0,39.0,42.0,48.0,44.0,57.0,46.0,34.0,54.0,42.0,27.0,47.0,29.0,36.0,39.0,29.0,45.0,27.0,35.0,32.0,18.0,27.0,25.0,18.0,16.0,12.0,7.0,3.0,5.0,0.0,1.0,0.0,0.0,0.0,0.0,10.0,10.0,21.0,8.0,21.0,14.0,11.0,19.0,16.0,20.0,11.0,24.0,21.0,31.0,20.0,16.0,20.0,21.0,33.0,27.0,41.0,25.0,27.0,36.0,22.0,36.0,40.0,34.0,38.0,24.0,32.0,35.0,17.0,38.0,19.0,27.0,38.0,29.0,22.0,22.0,24.0,34.0,20.0,29.0,48.0,26.0,40.0,48.0,16.0,27.0,28.0,19.0,23.0,22.0,9.0,13.0,8.0,1.0,3.0,2.0,0.0,0.0,1.0,9.580291971,9.333333332999999,7.531380753,191,51,159,50,113,29,155,54,159,48,113,43,98,72,346,299,269,31.56934307,28.47619048,28.13807531,113.22957199999999,117.8423237,127.0783848,645,653,615,58.85036496,62.19047619,64.33054393,158.64341090000002,143.7886677,115.73983740000001,53.64341085,45.78866769,43.7398374,329.5238095,305.10204080000005,373.6111111,489,44.61678832,28.0952381,295,24.05857741,230,104.2553191,197.22222219999998,248.6486486,44.55252918,229,15.72052402,69.08713693,333,7.807807808,34.91686461,147,12.24489796,9.170305677,3.0030030030000003,6.802721087999999,57506.56861,162209468.6,956.0,930.0,936.0,946.0,970.0,977.0,1008.0,1001.0,1000.0,1029.0,1048.0,1050.0,1075.0,1113.0,1100.0,1088.0,1109.0,1127.0,1096.0,1106.0,1096.0,1101.0,1101.0,1091.0,1103.5,1116.0,1192.0,1402.0,1807.0,2236.0,2526.0,2701.0,2587.0,2591.0,2492.0,2686.0,162.2094727,16.55883566,15.36285125,15.97317319,15.94851372,16.65130868,15.57245677,13.78464502,11.13991662,8.643145046,7.34852275,6.879992776,6.802931925,6.725871074,6.787519754,6.787519754,6.756695414,6.818344095,6.756695414,6.947806324,6.836838698999999,6.707376469,6.781354886,6.861498171,6.627233184,6.473111482,6.460781746,6.343649253,6.164868078,6.1710329470000005,6.214187022999999,6.023076112999999,5.9799220360000005,5.831965202,5.770316521,5.733327312999999,5.8936138829999996,0,0,0,0,2,44332.00916,2536.9079739999997,10791.3963,10627.99725,3947.625031,58,280,0.006013643000000001,0,0.0,0.0,0.99,1.0
39051,2399,Cantabria,Cantabria,Pesquera,491,1072,581,731.720339,112.596021,0.6129,44.565964,43.953064000000005,18.30196,9.429756,9560.623315,12654.21627,3093.5929539999997,11111.32957,791.218227,30.447771999999997,2426.243625,2395.795853,1247.765676,590.960438,26.984425,3076.4530670000004,3049.468641,1340.20526,704.757783,14.329889999999999,2757.082218,2742.752328,1330.7444990000001,577.893963,1.0,0.0,0.0,1.0,0.0,0.0,0,0,0,1,0,0,1,0,0,0,1,0,0,0,0,0.0,0.0,1.0,1.0,0.0,0.0,1,2,1,1,0,1,0,1,1,1,2,0,1,1,0,1,0,-1,0,0,0,-1,-2,-1,0,0,-1,1,-1,-1,-1,-1,0,-1,-1,0,13.88888889,0,0,15.87301587,0,0,0.0,0.0,0.0,18.18181818,0.0,0.0,21.27659574,0.0,0.0,0.0,20.83333333,0.0,0.0,0.0,20.83333333,0,0,14.70588235,15.87301587,0,0,18.86792453,37.73584906,17.54385965,18.18181818,0.0,19.23076923,0.0,21.27659574,21.27659574,20.0,40.81632653,0.0,20.83333333,17.85714286,0.0,13.88888889,0,-14.70588235,0,0,0,-18.86792453,-37.73584906,-17.54385965,0.0,0.0,-19.23076923,21.27659574,-21.27659574,-21.27659574,-20.0,-20.40816327,0.0,-20.83333333,-17.85714286,0.0,4,3,1,5,5,0,-1,-2,1,5,5,0,1,1,0,4,4,0,1,1,0,0,0,0,1,1,0,2,2,0,3,2,1,-1,0,-1,2,2,0,2,2,0,0,0,0,4,4,0,4,3,1,0,1,-1,13,13,0,2,1,1,11,12,-1,4,4,0,3,3,0,1,1,0,6,5,1,3,3,0,3,2,1,1.0,2.0,1.0,1.0,4.0,4.0,0.0,2.0,0.0,3.0,1.0,3.0,4.0,2.0,4.0,2.0,2.0,3.0,6.0,3.0,6.0,2.0,5.0,5.0,2.0,7.0,7.0,8.0,6.0,4.0,7.0,2.0,8.0,11.0,7.0,5.0,6.0,5.0,4.0,10.0,2.0,6.0,5.0,5.0,7.0,1.0,9.0,5.0,2.0,5.0,3.0,7.0,3.0,3.0,3.0,0.0,0.0,1.0,0.0,0.0,0.0,0.0,0.0,0.0,1.0,1.0,0.0,4.0,1.0,0.0,1.0,0.0,3.0,0.0,1.0,2.0,1.0,1.0,1.0,1.0,2.0,5.0,1.0,4.0,2.0,4.0,2.0,2.0,3.0,5.0,5.0,4.0,1.0,4.0,2.0,6.0,7.0,5.0,5.0,5.0,4.0,2.0,6.0,1.0,3.0,2.0,1.0,3.0,1.0,5.0,3.0,0.0,2.0,0.0,3.0,0.0,2.0,1.0,0.0,0.0,0.0,0.0,0.0,0.0,0.0,0.0,1.0,1.0,0.0,1.0,0.0,3.0,0.0,1.0,0.0,0.0,1.0,2.0,2.0,1.0,3.0,1.0,1.0,1.0,1.0,2.0,2.0,0.0,1.0,3.0,0.0,4.0,2.0,3.0,2.0,3.0,3.0,0.0,2.0,4.0,2.0,0.0,1.0,1.0,2.0,4.0,1.0,3.0,3.0,4.0,4.0,0.0,4.0,2.0,2.0,3.0,3.0,4.0,3.0,1.0,2.0,0.0,0.0,1.0,0.0,0.0,0.0,0.0,0.0,6.41025641,11.11111111,2.43902439,13,3,15,2,16,2,11,2,15,6,16,0,8,2,24,24,29,30.76923077,33.33333333,35.36585366,116.66666670000001,125.0,148.4848485,49,40,51,62.82051282,55.55555556,62.19512195,53.97959184,68.0,58.8627451,48.97959184,60.0,56.8627451,480.0,300.0,1450.0,266,341.025641,29.16666667,21,21.95121951,18,133.3333333,500.0,200.0,41.66666667,15,6.666666667,62.5,20,10.0,45.45454545,15,6.666666667,0.0,5.0,6.666666667,12114.35435,8839607.362,82.0,79.0,78.0,68.0,68.0,71.0,73.0,74.0,71.0,71.0,89.0,72.0,64.0,69.0,75.0,79.0,79.0,82.0,78.0,86.0,94.0,95.0,95.0,100.0,103.0,106.0,110.0,113.0,171.0,289.0,285.0,288.0,295.0,317.0,327.0,358.0,8.839607239,40.49953695,36.99259381,35.86132183,33.37252347,32.58063308,32.24125148,32.69376028,19.34475089,12.7833734,12.443991800000001,11.99148301,11.65210141,11.31271982,10.74708383,10.74708383,10.63395663,9.728939044,8.823921459,9.276430251,8.937048657,8.937048657,8.484539864,7.805776675,7.240140684,8.14515827,10.06832064,8.032031071,8.032031071,8.371412666,8.258285468,8.032031071,7.692649477000001,7.692649477000001,8.823921459,8.937048657,9.276430251,0,0,0,0,0,30609.88608,4762.953116,10922.12494,10420.84165,2787.054576,0,0,0.013361277,0,0.0,0.0,1.0,1.0
39052,2400,Cantabria,Cantabria,Pi√©lagos,-3,340,343,82.156182,61.284064,0.0,27.977474,27.977474,7.444591,5.142568,2755.871939,10421.329909999999,7665.457972,6915.047875,1563.1279240000001,7.757469,4967.250951,4959.493483,1764.5401120000001,1027.6657109999999,30.768402000000002,5632.389774,5601.621372,2960.714497,1200.097992,9.167629,4200.018882,4190.851253,2125.8789030000003,898.270198,159.0,125.0,196.0,181.0,212.0,248.0,238,257,308,304,290,358,320,317,305,279,249,233,238,227,196,116.0,96.0,142.0,131.0,109.0,128.0,105,117,117,140,122,130,144,135,146,203,169,171,160,152,157,43,29,54,50,103,120,133,140,191,164,168,228,176,182,159,76,80,62,78,75,39,403.5532995,320.5128205,514.4356955,472.5848564,565.3333333,685.0828729,650.273224,713.8888889,865.1685392999999,886.2973761,870.8708708999999,1104.938272,1009.4637220000001,1029.220779,1013.2890369999999,972.1254355000001,889.2857142999999,832.1428571,856.1151079,850.1872658999999,611.5384615,294.4162437,246.1538462,372.7034121,342.0365535,290.6666667,353.5911602,286.8852459,325.0,328.65168539999996,408.1632653,366.3663664,401.23456789999994,454.2586751,438.3116883,485.04983389999995,707.3170732000001,595.0704225,610.7142857000001,575.5395682999999,569.2883895,603.8461538,109.1370558,74.35897436,141.7322835,130.5483029,274.6666667,331.4917127,363.38797810000005,388.8888889,536.5168539,478.1341108,504.5045045,703.7037037,555.2050472999999,590.9090909,528.2392027,264.80836239999996,281.69014080000005,221.4285714,280.5755396,280.8988764,150.0,1431,1325,106,1206,1105,101,225,220,5,1395,1313,82,1177,1010,167,218,303,-85,1434,1364,70,1226,1129,97,208,235,-27,1295,1233,62,1149,1068,81,146,165,-19,1490,1364,126,1181,1050,131,309,314,-5,1533,1372,161,1284,1192,92,249,180,69,1587,1424,163,1324,1251,73,263,173,90,1529,1362,167,1396,1299,97,133,63,70,1482,1368,114,1107,1065,42,375,303,72,1224.0,1560.0,832.0,1772.0,1315.0,626.0,1757.0,933.0,666.0,1436.0,851.0,780.0,1068.0,992.0,1014.0,981.0,1694.0,1147.0,1348.0,2302.0,1429.0,2118.0,2269.0,1380.0,2891.0,1969.0,1216.0,2605.0,1652.0,1047.0,2119.0,1362.0,844.0,1700.0,1074.0,691.0,1456.0,925.0,498.0,1078.0,646.0,586.0,870.0,497.0,542.0,598.0,527.0,429.0,395.0,401.0,270.0,358.0,185.0,149.0,196.0,88.0,61.0,54.0,24.0,11.0,11.0,2.0,6.0,639.0,786.0,428.0,903.0,654.0,312.0,886.0,490.0,323.0,722.0,427.0,395.0,560.0,496.0,526.0,448.0,809.0,565.0,617.0,1166.0,749.0,990.0,1147.0,688.0,1480.0,1037.0,611.0,1314.0,900.0,551.0,1096.0,691.0,433.0,880.0,551.0,355.0,743.0,462.0,253.0,520.0,335.0,287.0,428.0,232.0,267.0,298.0,256.0,181.0,160.0,147.0,110.0,126.0,60.0,51.0,51.0,25.0,20.0,10.0,4.0,1.0,2.0,0.0,1.0,585.0,774.0,404.0,869.0,661.0,314.0,871.0,443.0,343.0,714.0,424.0,385.0,508.0,496.0,488.0,533.0,885.0,582.0,731.0,1136.0,680.0,1128.0,1122.0,692.0,1411.0,932.0,605.0,1291.0,752.0,496.0,1023.0,671.0,411.0,820.0,523.0,336.0,713.0,463.0,245.0,558.0,311.0,299.0,442.0,265.0,275.0,300.0,271.0,248.0,235.0,254.0,160.0,232.0,125.0,98.0,145.0,63.0,41.0,44.0,20.0,10.0,9.0,2.0,5.0,14.93250844,17.90483355,18.25619359,1136,1061,1311,1878,1965,2325,918,1063,1311,1930,1965,2428,3808,4753,2054,2370,3560,14.44038245,11.14350197,13.67390052,99.85949136,100.7740961,97.80428506,10046,15090,17722,70.62710911,70.95166447,68.0699059,2144.445949,3823.7057649999997,4773.088025999999,20.44594864,15.70576541,20.08802618,96.70433145,62.23739496,74.90006312,1065,7.487345332,38.51796126,8192,34.42289226,8962,63.84615385,108.69565220000001,101.3927577,49.65575383,3534,23.54272779,95.12885868,10077,15.48079786,36.59778149,4817,25.41000623,11.43180532,7.680857398,12.14448827,63632.49824,84264762.18,26035.0,25731.0,25559.0,25223.0,24918.0,24574.0,24360.0,23999.0,23661.0,23211.0,22223.0,21268.0,20081.0,18934.0,17681.0,16578.0,15748.0,14849.0,14224.0,13389.0,12517.0,11862.0,11181.0,11075.0,10908.0,10741.0,9537.0,9282.0,9365.0,9710.0,8487.0,8040.0,7282.0,6418.0,6208.0,5698.0,84.26476288,67.62019859,73.67255052,76.16469543,86.41809163,95.41354803,100.7182565,115.2320338,111.1377957,110.1528051,113.17898100000001,127.46727849999999,129.4491271,131.4309757,132.6889155,140.77058540000002,148.54370409999999,158.89203909999998,168.80128200000001,176.2183799,186.8871336,196.7370397,209.82673419999998,224.6965321,238.30839029999999,252.39494269999997,263.7282684,275.4532168,280.79352739999996,284.80469389999996,289.0888097,291.628424,295.71079469999995,299.3303385,303.3177704,305.35895580000005,308.9666322,0,3,4,1,5,6315.5993530000005,3233.334292,2336.3892969999997,3298.25292,1848.820948,153,842,0.043297622,0,0.98,0.59,1.0,1.0
39016,2401,Cantabria,Cantabria,Camargo,-4,288,292,53.255221,53.027727,0.0,24.326732999999997,24.326732999999997,4.852044,4.255798,47.623313,7692.543947,7644.9206349999995,3048.574336,1653.064733,20.697426,3088.079072,3067.3816460000003,1299.897474,734.8643910000001,23.484485999999997,4870.110897,4846.626411,1718.785423,1071.888564,20.246904999999998,3577.734408,3557.4875030000003,1747.256854,809.0941349999999,205.0,209.0,257.0,273.0,313.0,370.0,346,368,384,344,324,276,265,229,214,186,203,200,175,157,145,182.0,190.0,174.0,195.0,206.0,181.0,214,237,198,199,191,208,251,260,229,225,199,250,257,270,283,23,19,83,78,107,189,132,131,186,145,133,68,14,-31,-15,-39,4,-50,-82,-113,-138,540.8970976,545.691906,707.9889807,782.234957,928.7833828,1121.212121,1064.615385,1157.232704,1267.326733,1142.857143,1102.040816,958.3333332999998,933.0985914999999,820.7885305,767.0250896000001,683.8235294,768.9393938999999,757.5757576000001,700.0,656.9037657,864.978903,480.2110818,496.0835509,479.338843,558.739255,611.2759644,548.4848485,658.4615385,745.2830188999999,653.4653465,661.1295681,649.6598639,722.2222222,883.8028168999999,931.8996416000001,820.7885305,827.2058824,739.7769517,946.9696970000001,1028.0,1129.7071130000002,1194.092827,60.68601583,49.60835509,228.6501377,223.495702,317.5074184,572.7272727,406.1538462,411.9496855,613.8613861,481.72757479999996,452.3809524,236.11111110000002,49.29577465,-111.1111111,-53.76344086,-143.3823529,14.86988848,-189.39393940000002,-328.0,-472.80334730000004,-582.2784809999999,1310,1225,85,1477,1301,176,-167,-76,-91,1217,1116,101,1461,1300,161,-244,-184,-60,1147,1052,95,1281,1209,72,-134,-157,23,1273,1166,107,1290,1194,96,-17,-28,11,1282,1151,131,1262,1170,92,20,-19,39,1217,1081,136,1286,1155,131,-69,-74,5,1418,1200,218,1327,1251,76,91,-51,142,1426,1189,237,1461,1279,182,-35,-90,55,1401,1258,143,1136,1107,29,265,151,114,910.0,1901.0,1205.0,1291.0,1708.0,1170.0,1841.0,1495.0,1209.0,1801.0,1422.0,1484.0,1428.0,1608.0,1950.0,1332.0,1973.0,2362.0,1374.0,2930.0,2203.0,1688.0,3035.0,2280.0,2569.0,2772.0,2183.0,2898.0,2549.0,1903.0,2668.0,2354.0,1698.0,2406.0,1888.0,1366.0,2248.0,1619.0,921.0,1839.0,1140.0,1056.0,1475.0,926.0,1062.0,1036.0,1006.0,767.0,732.0,689.0,473.0,585.0,364.0,257.0,302.0,125.0,102.0,62.0,45.0,24.0,12.0,3.0,1.0,466.0,984.0,634.0,667.0,886.0,597.0,971.0,786.0,614.0,923.0,738.0,757.0,751.0,838.0,1002.0,701.0,1015.0,1197.0,704.0,1463.0,1099.0,827.0,1476.0,1151.0,1242.0,1420.0,1099.0,1368.0,1302.0,953.0,1333.0,1185.0,821.0,1221.0,933.0,696.0,1105.0,783.0,444.0,868.0,557.0,503.0,679.0,433.0,484.0,478.0,432.0,325.0,296.0,248.0,190.0,198.0,123.0,75.0,81.0,42.0,29.0,15.0,9.0,1.0,3.0,0.0,0.0,444.0,917.0,571.0,624.0,822.0,573.0,870.0,709.0,595.0,878.0,684.0,727.0,677.0,770.0,948.0,631.0,958.0,1165.0,670.0,1467.0,1104.0,861.0,1559.0,1129.0,1327.0,1352.0,1084.0,1530.0,1247.0,950.0,1335.0,1169.0,877.0,1185.0,955.0,670.0,1143.0,836.0,477.0,971.0,583.0,553.0,796.0,493.0,578.0,558.0,574.0,442.0,436.0,441.0,283.0,387.0,241.0,182.0,221.0,83.0,73.0,47.0,36.0,23.0,9.0,3.0,1.0,13.95856052,16.17647059,13.25376267,2135,1739,2454,2448,3425,1938,1607,1845,2454,2656,3425,2104,5104,4042,3742,4298,6043,14.57392117,13.6219574,19.81506378,97.43175702,98.45273288,95.49358974,18350,22150,20412,71.46751831,70.20157201,66.93117356,3604.392371,5123.404063,4071.6051340000004,20.39237057,19.40406321,29.60513423,104.4084821,84.20846395,149.50519540000002,5928,23.08770837,35.76952333,11286,27.96668525,8529,62.06199461,113.8537271,124.8195447,48.48135333,6305,19.11181602,86.42052959,13740,13.83551674,33.0,5148,17.67676768,9.05630452,6.6739446870000005,8.624708625,31999.37381,36963141.75,30497.0,30320.0,30260.0,30263.0,30556.0,30611.0,30766.0,31007.0,31334.0,31594.0,31556.0,31552.0,31404.0,31086.0,30663.0,30024.0,28429.0,26955.0,25676.0,23914.0,23308.0,22749.0,22535.0,22788.0,22549.5,22311.0,20311.0,18760.0,15541.0,12822.0,10523.0,10198.0,9642.0,7335.0,6043.0,4923.0,36.9631424,133.1867282,163.4871823,198.4409205,260.85444509999996,275.8964563,284.6889988,346.88609160000004,420.44585480000006,507.5326063999999,549.4933245,603.6012783,610.0536517999999,616.5060252999999,609.6613691,615.4509202,630.5740933,646.9688033,694.6379105000001,729.239947,769.1175089,812.268602,829.5560932999999,840.9999255000001,849.6030901,853.6070787000001,853.7152946,854.7433457000001,847.7093117999999,838.8626613,832.3426529,828.1492865,826.6613177,818.7345025000001,818.6533406000001,820.2765792,825.0651331,0,0,14,1,2,4578.2658329999995,6086.935354,1296.4423960000001,2778.3783510000003,1827.830091,64,291,0.000159844,0,1.0,0.83,1.0,1.0
39017,2402,Cantabria,Cantabria,Campoo de Yuso,745,1316,571,920.5264080000001,106.054428,0.0,33.572449,33.572449,6.558114,5.794327,4029.926075,21787.356659999998,17757.43059,12907.02601,4402.384174,60.106244999999994,9285.169631,9225.063385,5359.88767,1960.25785,1314.703636,17023.87005,15709.16642,8915.418033,3649.299293,2533.157427,10752.04176,8218.884329,7535.7115109999995,1765.9640940000002,6.0,4.0,4.0,8.0,5.0,3.0,3,7,1,3,5,6,4,2,4,6,4,1,7,5,6,6.0,8.0,12.0,5.0,11.0,11.0,6,17,7,7,13,16,12,11,9,12,7,11,10,11,11,0,-4,-8,3,-6,-8,-3,-10,-6,-4,-8,-10,-8,-9,-5,-6,-3,-10,-3,-6,-5,16.21621622,10.86956522,11.23595506,22.85714286,14.83679525,9.493670886,9.646302251,23.02631579,3.3003300330000003,10.06711409,16.94915254,21.20141343,14.70588235,7.751937984,16.260162599999997,24.29149798,17.39130435,4.347826087,31.96347032,24.03846154,28.84615385,16.21621622,21.73913043,33.70786517,14.28571429,32.64094955,34.81012658,19.292604500000003,55.92105263,23.10231023,23.48993289,44.06779661,56.53710247,44.11764706,42.63565891,36.58536585,48.58299595,29.91452991,47.82608696,45.66210046,52.88461538,52.88461538,0,-10.86956522,-22.47191011,8.571428571,-17.8041543,-25.3164557,-9.646302251,-32.89473684,-19.8019802,-13.42281879,-27.11864407,-35.33568905,-29.41176471,-34.88372093,-20.32520325,-24.29149798,-12.82051282,-43.47826087,-13.69863014,-28.84615385,-24.03846154,16,14,2,28,20,8,-12,-6,-6,21,21,0,24,24,0,-3,-3,0,37,34,3,17,17,0,20,17,3,39,37,2,25,21,4,14,16,-2,17,12,5,19,19,0,-2,-7,5,20,19,1,20,20,0,0,-1,1,28,25,3,28,27,1,0,-2,2,32,29,3,21,19,2,11,10,1,34,31,3,20,20,0,14,11,3,23.0,16.0,22.0,38.0,30.0,13.0,26.0,21.0,19.0,29.0,16.0,37.0,24.0,32.0,48.0,18.0,41.0,54.0,39.0,57.0,47.0,47.0,44.0,40.0,64.0,40.0,58.0,50.0,58.0,43.0,34.0,51.0,48.0,50.0,54.0,41.0,48.0,33.0,29.0,52.0,30.0,45.0,33.0,34.0,57.0,31.0,51.0,68.0,27.0,51.0,37.0,32.0,33.0,16.0,12.0,11.0,11.0,3.0,3.0,5.0,0.0,0.0,2.0,13.0,10.0,13.0,19.0,17.0,6.0,13.0,11.0,11.0,16.0,9.0,14.0,13.0,16.0,35.0,8.0,27.0,26.0,19.0,31.0,26.0,26.0,29.0,23.0,33.0,24.0,29.0,34.0,34.0,24.0,21.0,31.0,31.0,29.0,32.0,17.0,28.0,17.0,19.0,33.0,14.0,23.0,17.0,20.0,26.0,18.0,27.0,31.0,11.0,20.0,13.0,15.0,15.0,6.0,3.0,2.0,3.0,2.0,0.0,0.0,0.0,0.0,2.0,10.0,6.0,9.0,19.0,13.0,7.0,13.0,10.0,8.0,13.0,7.0,23.0,11.0,16.0,13.0,10.0,14.0,28.0,20.0,26.0,21.0,21.0,15.0,17.0,31.0,16.0,29.0,16.0,24.0,19.0,13.0,20.0,17.0,21.0,22.0,24.0,20.0,16.0,10.0,19.0,16.0,22.0,16.0,14.0,31.0,13.0,24.0,37.0,16.0,31.0,24.0,17.0,18.0,10.0,9.0,9.0,8.0,1.0,3.0,5.0,0.0,0.0,0.0,7.297297297,9.490084986,12.79411765,137,24,115,29,91,42,104,30,115,38,91,45,67,87,241,213,190,32.56756757,30.16997167,27.94117647,104.4198895,120.625,120.0647249,445,426,403,60.13513514,60.33994334,59.26470588,108.1573034,117.0,134.146402,54.15730337,50.0,47.14640199,446.29629630000005,317.9104478,218.3908046,6709,906.6216216,28.18696884,199,29.41176471,200,78.37837838,206.25,165.51724140000002,42.26519337,153,14.37908497,71.875,230,6.956521738999999,37.21682848,115,20.0,5.882352941000001,2.6086956519999998,8.695652174,48688.62275,89431452.16,680.0,670.0,669.0,668.0,682.0,696.0,685.0,668.0,685.0,703.0,697.0,706.0,705.0,715.0,724.0,715.0,727.0,737.0,740.0,753.0,770.0,739.0,730.0,772.0,766.5,761.0,813.0,957.0,1209.0,1748.0,2315.0,2396.0,2400.0,2368.0,2215.0,1701.0,89.43144989,19.02015457,24.76757341,26.47838096,26.83619692,26.79146992,25.88574828,19.54569676,13.5187342,10.70093352,9.090761706,8.509310773,8.570810391,8.632310009,8.162676563,8.263312301000001,8.609946512,8.419856783,8.27449405,8.240948804,8.129131317,7.994950332,8.095586071,7.994950332,7.883132845,7.894314594,7.793678855,7.860769348,7.659497871,7.469408142000001,7.659497871,7.782497106,7.625952624,7.469408142000001,7.480589891,7.49177164,7.603589127,0,1,2,0,1,38134.20404,4655.837595,4288.889586,11092.55691,3657.872479,9,66,0.003899766,0,1.0,0.0,1.0,1.0
39018,2403,Cantabria,Cantabria,Cartes,21,615,594,201.65195400000002,127.851619,0.0,44.455868,44.455868,11.437926,6.879367,1416.777313,8358.255711,6941.478398,4843.379559,1695.821296,18.129879000000003,4325.837098,4307.707219,1834.70898,1096.1870900000001,26.179758,4163.2476240000005,4137.067865999999,1920.1066670000002,943.806252,199.665428,4519.992184000001,4320.326756,2405.030381,964.628358,65.0,58.0,62.0,67.0,80.0,79.0,80,89,110,99,86,103,75,77,80,80,72,74,57,36,38,19.0,23.0,14.0,20.0,27.0,14.0,22,18,22,16,28,33,24,19,35,28,33,27,32,18,32,46,35,48,47,53,65,58,71,88,83,58,70,51,58,45,52,39,47,25,18,6,161.6915423,147.2081218,159.7938144,178.1914894,213.9037433,208.994709,217.3913043,239.24731180000003,301.369863,278.0898876,240.2234637,291.7847025,221.89349109999998,237.654321,253.968254,263.1578947,244.0677966,250.84745759999998,199.3006993,123.7113402,224.137931,47.26368159,58.37563452,36.08247423,53.19148936,72.19251337,37.03703704,59.782608700000004,48.38709677,60.2739726,44.94382022,78.21229050000001,93.48441926,71.00591716,58.64197531,111.1111111,92.10526316,108.91089109999999,91.52542373,111.8881119,61.8556701,110.34482759999999,114.4278607,88.83248731,123.7113402,125,141.7112299,171.957672,157.6086957,190.86021509999998,241.0958904,233.14606740000002,162.01117319999997,198.30028330000002,150.887574,179.0123457,142.8571429,171.05263159999998,128.7128713,159.3220339,87.41258741,61.8556701,20.68965517,259,252,7,264,241,23,-5,11,-16,291,276,15,268,254,14,23,22,1,258,241,17,311,300,11,-53,-59,6,261,254,7,232,213,19,29,41,-12,246,230,16,277,256,21,-31,-26,-5,256,234,22,264,260,4,-8,-26,18,251,232,19,302,289,13,-51,-57,6,261,241,20,311,303,8,-50,-62,12,281,266,15,258,246,12,23,20,3,270.0,464.0,276.0,384.0,316.0,198.0,433.0,226.0,172.0,313.0,188.0,154.0,252.0,215.0,197.0,220.0,501.0,419.0,305.0,747.0,484.0,507.0,615.0,449.0,743.0,486.0,295.0,560.0,362.0,218.0,492.0,267.0,173.0,349.0,200.0,130.0,276.0,162.0,99.0,200.0,123.0,134.0,153.0,119.0,144.0,104.0,136.0,97.0,81.0,91.0,60.0,72.0,43.0,26.0,32.0,16.0,8.0,2.0,2.0,1.0,2.0,0.0,1.0,134.0,241.0,142.0,197.0,169.0,99.0,228.0,128.0,84.0,170.0,92.0,79.0,136.0,100.0,99.0,106.0,229.0,203.0,136.0,402.0,257.0,228.0,324.0,243.0,372.0,253.0,167.0,291.0,198.0,118.0,247.0,140.0,95.0,183.0,99.0,77.0,142.0,93.0,41.0,98.0,63.0,63.0,80.0,50.0,70.0,48.0,61.0,37.0,35.0,38.0,24.0,30.0,16.0,9.0,11.0,8.0,2.0,0.0,0.0,0.0,0.0,0.0,1.0,136.0,223.0,134.0,187.0,147.0,99.0,205.0,98.0,88.0,143.0,96.0,75.0,116.0,115.0,98.0,114.0,272.0,216.0,169.0,345.0,227.0,279.0,291.0,206.0,371.0,233.0,128.0,269.0,164.0,100.0,245.0,127.0,78.0,166.0,101.0,53.0,134.0,69.0,58.0,102.0,60.0,71.0,73.0,69.0,74.0,56.0,75.0,60.0,46.0,53.0,36.0,42.0,27.0,17.0,21.0,8.0,6.0,2.0,2.0,1.0,2.0,0.0,0.0,17.29585007,19.05663952,18.90434783,265,321,294,468,344,528,206,325,294,538,344,559,1006,1087,471,530,646,12.61044177,10.03978026,11.23478261,104.6575342,105.0097087,99.79152189,2618,3743,4017,70.09370817,70.90358022,69.86086957,663.9908327,1020.159765,1103.081653,17.9908327,14.15976489,16.08165297,72.91021672,52.68389662,59.42962282,363,9.718875502000001,41.86398939,2210,36.782608700000004,2115,64.28571429,86.17021277,88.17891374,57.42465753,1048,26.33587786,106.8737864,2752,16.86046512,39.88881167,1148,23.51916376,12.78625954,8.103197674,11.846689900000001,18822.257719999998,18904639.82,5750.0,5731.0,5747.0,5778.0,5742.0,5733.0,5670.0,5687.0,5608.0,5558.0,5423.0,5279.0,5118.0,4761.0,4617.0,4268.0,3982.0,3752.0,3735.0,3681.0,3590.0,3415.0,3243.0,2804.0,2879.0,2954.0,2102.0,2191.0,2601.0,2839.0,2431.0,2193.0,2466.0,1742.0,1463.0,1338.0,18.9046402,70.77627429,77.38840754,92.14668895,130.44416470000002,116.00326570000001,128.5927674,150.17477030000003,137.5852686,115.8974716,111.1896327,156.25793290000001,152.290653,148.323373,171.545185,180.6434803,189.9004669,194.7140999,197.5705415,198.4697916,210.6361168,225.7646776,244.2257537,251.84293119999998,270.72718369999996,279.2436113,286.8607888,294.0018928,296.64674610000003,300.82561430000004,299.92636410000006,303.2588793,303.73495289999994,305.6392473,303.9994382,303.1530852,304.15812939999995,0,1,0,0,1,5528.395502,10676.884590000001,2904.335325,4047.177599,2363.363877,33,135,0.301850495,0,1.0,1.0,1.0,1.0
39019,2404,Cantabria,Cantabria,Casta√±eda,40,339,299,156.239216,82.434129,0.0,29.230228000000004,29.230228000000004,9.810433,6.428535,7524.860093000001,12213.88304,4689.022945000001,9858.354361,1090.139874,14.431388,3010.950887,2996.519499,1133.7484060000002,669.4983980000001,23.489088,3822.865539,3799.3764509999996,1596.251779,823.981901,2216.4778579999997,7046.62338,4830.145522,4484.5099979999995,1113.974341,14.0,11.0,20.0,15.0,24.0,19.0,21,25,26,40,53,26,39,41,43,53,32,35,34,27,24,15.0,23.0,19.0,21.0,24.0,14.0,18,13,19,20,17,27,18,20,33,26,14,23,25,21,27,-1,-12,1,-6,0,5,3,12,7,20,36,-1,21,21,10,27,18,12,9,6,-3,62.22222222,49.10714286,90.90909091,69.44444444,112.1495327,94.52736318,103.960396,126.26262630000001,128.7128713,208.33333330000002,291.2087912,138.29787230000002,224.137931,236.99421969999997,263.803681,339.7435897,230.2158273,251.79856119999997,241.1347518,192.8571429,103.7037037,66.66666667,102.6785714,86.36363636,97.22222222,112.1495327,69.65174129,89.10891089,65.65656566,94.05940594,104.16666670000001,93.40659341,143.61702130000003,103.44827590000001,115.60693640000001,202.4539877,166.66666669999998,96.55172414,165.4676259,177.3049645,150.0,200.0,-4.444444444,-53.57142857,4.545454545,-27.77777778,0,24.87562189,14.85148515,60.60606061,34.65346535,104.16666670000001,197.80219780000002,-5.319148936,120.68965520000002,121.3872832,61.34969325,173.0769231,124.13793100000001,86.33093525,63.82978723,42.85714286,-22.22222222,227,220,7,149,149,0,78,71,7,193,188,5,178,175,3,15,13,2,172,171,1,161,158,3,11,13,-2,155,150,5,174,169,5,-19,-19,0,204,198,6,161,154,7,43,44,-1,210,202,8,153,148,5,57,54,3,246,231,15,151,147,4,95,84,11,215,207,8,175,161,14,40,46,-6,216,200,16,155,153,2,61,47,14,160.0,140.0,79.0,174.0,109.0,57.0,183.0,87.0,62.0,136.0,83.0,83.0,113.0,118.0,126.0,124.0,217.0,141.0,210.0,262.0,138.0,312.0,254.0,137.0,337.0,194.0,120.0,267.0,158.0,89.0,273.0,113.0,89.0,191.0,99.0,88.0,138.0,92.0,79.0,99.0,85.0,109.0,102.0,93.0,70.0,68.0,82.0,71.0,72.0,53.0,46.0,50.0,40.0,25.0,16.0,11.0,7.0,4.0,3.0,5.0,0.0,0.0,0.0,84.0,76.0,42.0,85.0,58.0,31.0,96.0,42.0,35.0,70.0,42.0,44.0,56.0,55.0,57.0,57.0,97.0,79.0,101.0,134.0,69.0,160.0,147.0,76.0,179.0,100.0,64.0,149.0,92.0,48.0,146.0,56.0,46.0,113.0,49.0,40.0,69.0,40.0,42.0,50.0,44.0,58.0,38.0,50.0,31.0,33.0,38.0,30.0,35.0,22.0,11.0,23.0,12.0,7.0,3.0,5.0,0.0,1.0,0.0,0.0,0.0,0.0,0.0,76.0,64.0,37.0,89.0,51.0,26.0,87.0,45.0,27.0,66.0,41.0,39.0,57.0,63.0,69.0,67.0,120.0,62.0,109.0,128.0,69.0,152.0,107.0,61.0,158.0,94.0,56.0,118.0,66.0,41.0,127.0,57.0,43.0,78.0,50.0,48.0,69.0,52.0,37.0,49.0,41.0,51.0,64.0,43.0,39.0,35.0,44.0,41.0,37.0,31.0,35.0,27.0,28.0,18.0,13.0,6.0,7.0,3.0,3.0,5.0,0.0,0.0,0.0,12.21468229,14.65329263,17.06833939,196,90,196,160,228,252,137,108,196,176,228,265,336,517,333,367,411,20.54287477,16.00523332,13.568834599999999,99.87669544,102.2045855,104.5239703,1090,1590,2101,67.24244294,69.34147405,69.36282602,228.55045869999998,359.081761,536.5621133000001,30.55045872,23.08176101,19.56211328,168.18181819999998,109.2261905,79.49709865,1317,81.24614436,37.85433929,868,37.17398481,1126,95.18072289,110.84337350000001,101.4705882,47.96547472,389,20.30848329,99.47089947,1128,12.41134752,42.06617151,623,25.68218299,9.511568123,5.673758865,12.19903692,19908.3028,19157722.39,3029.0,2968.0,2914.0,2809.0,2744.0,2687.0,2681.0,2659.0,2619.0,2525.0,2470.0,2293.0,2121.0,1917.0,1770.0,1744.0,1724.0,1696.0,1621.0,1582.0,1559.0,1423.0,1481.0,1481.0,1523.5,1566.0,1552.0,1616.0,1635.0,1668.0,1496.0,1566.0,1417.0,1323.0,1127.0,1112.0,19.15772247,58.04447797,58.82745204,69.05831327,73.96495079,81.74249325,78.08861424,87.06671695,85.34417399,84.35240683,81.01171745,81.74249325,79.52406671,77.30564017,77.30564017,74.27814042,81.37710535,82.57766559999999,84.61339819,88.52826855,89.98982016,91.03378559,92.39094065,100.0640866,110.712534,119.69063670000001,128.9297307,131.80063570000002,136.70727319999997,138.7952041,139.943566,140.25675569999999,143.2320571,146.6249448,152.1057633,154.92446999999999,158.1085645,0,0,4,0,1,12540.96093,4598.925409,2313.813935,4849.081579,1380.475091,17,99,0.00037447099999999997,0,0.94,0.09,1.0,1.0
39020,2405,Cantabria,Cantabria,Castro-Urdiales,-2,726,728,233.073115,159.399608,0.0,50.417927,50.417927,14.633712,8.016501,40.585146,11187.63239,11147.04724,5667.548994,2255.484547,21.700385,7920.958917,7899.258531999999,2709.4380149999997,1734.1335010000003,14.38132,7316.439713,7302.058394,2458.315538,1456.454392,3071.906039,14713.28601,11641.37997,9332.560887,2795.692214,250.0,259.0,273.0,315.0,361.0,418.0,335,348,416,401,390,333,327,296,248,228,234,244,194,181,187,195.0,186.0,183.0,209.0,169.0,187.0,173,202,214,199,215,188,206,193,218,196,198,253,226,268,287,55,73,90,106,192,231,162,146,202,202,175,145,121,103,30,32,36,-9,-32,-87,-100,355.6187767,373.7373737,399.122807,471.5568862,554.53149,647.0588235,531.7460317,560.3864734,693.3333332999999,676.222597,662.139219,577.1230502999999,582.8877004999999,562.7376426,469.69696969999995,444.4444444,483.4710744,504.1322313999999,419.0064795,403.11804010000003,570.7762557,277.3826458,268.3982684,267.5438596,312.8742515,259.6006144,289.4736842,274.60317460000005,325.2818035,356.6666667,335.5817875,365.02546689999997,325.8232236,367.20142599999997,366.9201521,412.87878789999996,382.0662768,393.638171,522.7272727,488.12095030000006,596.8819599,655.2511416,78.23613087,105.3391053,131.5789474,158.6826347,294.9308756,357.5851393,257.1428571,235.1046699,336.6666667,340.64080939999997,297.1137521,251.2998267,215.68627450000002,195.8174905,56.81818182,62.37816764,71.57057654,-18.59504132,-69.11447084,-193.7639198,-228.3105023,1752,1563,189,1935,1691,244,-183,-128,-55,1698,1528,170,1913,1556,357,-215,-28,-187,1657,1460,197,1914,1585,329,-257,-125,-132,1669,1449,220,1587,1448,139,82,1,81,1763,1470,293,1789,1578,211,-26,-108,82,1864,1546,318,1652,1504,148,212,42,170,2093,1684,409,1969,1585,384,124,99,25,1933,1495,438,1661,1517,144,272,-22,294,2360,2115,245,1539,1356,183,821,759,62,1197.0,2086.0,1382.0,1570.0,1849.0,1075.0,2014.0,1387.0,1061.0,1921.0,1287.0,1005.0,1449.0,1387.0,1325.0,1311.0,2070.0,2047.0,1629.0,3305.0,2807.0,2216.0,3850.0,2559.0,3106.0,3289.0,2194.0,3540.0,2715.0,1759.0,3175.0,2193.0,1397.0,2636.0,1602.0,1141.0,2112.0,1363.0,820.0,1515.0,1048.0,969.0,1242.0,889.0,881.0,907.0,891.0,607.0,670.0,576.0,397.0,508.0,335.0,198.0,200.0,104.0,92.0,50.0,28.0,17.0,7.0,4.0,1.0,620.0,1044.0,730.0,787.0,959.0,546.0,982.0,730.0,584.0,998.0,686.0,506.0,757.0,704.0,637.0,659.0,1016.0,998.0,825.0,1636.0,1409.0,1085.0,2002.0,1332.0,1494.0,1731.0,1151.0,1769.0,1430.0,957.0,1635.0,1204.0,756.0,1367.0,846.0,602.0,1079.0,702.0,393.0,766.0,494.0,459.0,583.0,413.0,400.0,407.0,379.0,274.0,259.0,214.0,161.0,180.0,117.0,59.0,56.0,29.0,16.0,14.0,5.0,6.0,3.0,0.0,1.0,577.0,1042.0,652.0,783.0,890.0,529.0,1032.0,657.0,477.0,923.0,601.0,499.0,692.0,683.0,688.0,652.0,1054.0,1049.0,804.0,1669.0,1398.0,1131.0,1848.0,1227.0,1612.0,1558.0,1043.0,1771.0,1285.0,802.0,1540.0,989.0,641.0,1269.0,756.0,539.0,1033.0,661.0,427.0,749.0,554.0,510.0,659.0,476.0,481.0,500.0,512.0,333.0,411.0,362.0,236.0,328.0,218.0,139.0,144.0,75.0,76.0,36.0,23.0,11.0,4.0,4.0,0.0,14.82261734,16.498233,14.49886277,1786,1658,2224,2589,2831,2392,1376,1860,2224,2733,2831,2389,5322,4781,3162,3875,5099,13.32265948,12.01252403,15.46322972,101.8712257,102.6638186,98.04804805,17054,23061,23095,71.85472318,71.48924298,70.03790751,3536.541105,5338.803261,4803.078372,18.54110473,16.80326092,22.07837194,89.88061399,72.81097332,106.65132820000001,2154,9.075587764,40.79298159,13159,31.81501137,10491,81.5920398,105.90520590000001,109.9427382,51.31411074,6033,22.90734295,95.4199912,15188,13.73452726,34.94294294,5818,20.57408044,10.80722692,6.860679483999999,9.917497422,56897.05655,95917256.08,32975.0,32270.0,32069.0,31977.0,31817.0,31901.0,31833.0,32144.0,32309.0,32522.0,32374.0,32258.0,31670.0,30814.0,29660.0,28542.0,27220.0,25388.0,23734.0,22394.0,20981.0,18719.0,16795.0,16795.0,15981.0,15167.0,13575.0,12912.0,12401.0,11988.0,11646.0,11963.0,12418.0,11786.0,12463.0,14191.0,95.91725922,147.9504327,129.9349054,122.8767387,129.465751,124.72207920000001,121.41714740000002,124.98272050000001,129.2885149,134.6160233,141.52823080000002,158.12586940000003,166.6123504,175.0988314,175.0988314,195.1577865,218.7406122,233.47205899999997,247.4424331,264.68646209999997,283.78625730000005,297.56896969999997,309.224849,321.2560518,330.1804103,336.3106939,337.5200695,339.0630661,336.8424021,335.1221695,331.87979160000003,332.588736,331.7129812,333.3810855,334.3402456,336.4358017,343.7858866,0,11,36,1,2,14372.1827,8916.145289,3605.6702520000003,5096.402213,3840.096596,178,813,0.004198655,0,0.76,0.0,1.0,1.0
39021,2406,Cantabria,Cantabria,Cieza,122,946,824,474.711622,167.765798,0.245168,49.246864,49.001697,17.227251000000003,7.0799259999999995,11652.99886,20034.475769999997,8381.47691,14949.936319999999,1760.2875789999998,859.7511880000001,10303.82515,9444.073962999999,5766.11279,2352.300984,9.424087,9121.697071999999,9112.272985,4244.044419,2404.027588,2327.850694,10816.8821,8489.03141,6450.573267,2136.8625920000004,5.0,0.0,6.0,6.0,9.0,4.0,4,3,3,2,5,2,1,4,0,1,4,5,4,4,9,11.0,14.0,7.0,10.0,6.0,14.0,10,9,14,4,6,8,17,10,10,13,14,8,12,10,5,-6,-14,-1,-4,3,-10,-6,-6,-11,-2,-1,-6,-16,-6,-10,-12,-10,-3,-8,-6,4,9.433962264,0,11.83431953,12.44813278,18.86792453,8.695652174,9.090909091,6.666666667,6.880733945,4.7619047619999995,12.65822785,5.235602094,2.6109660569999997,11.20448179,0.0,2.638522427,11.3960114,14.24501425,11.52737752,11.52737752,14.83679525,20.75471698,27.07930368,13.80670611,20.74688797,12.57861635,30.43478261,22.72727273,20.0,32.11009174,9.523809523999999,15.18987342,20.94240838,44.38642298,28.01120448,25.77319588,34.30079156,37.83783784,22.79202279,34.58213256,28.8184438,14.83679525,-11.32075472,-27.07930368,-1.972386588,-8.298755187,6.289308176,-21.73913043,-13.63636364,-13.33333333,-25.229357800000002,-4.7619047619999995,-2.53164557,-15.70680628,-41.77545692,-16.80672269,-25.77319588,-31.66226913,-27.02702703,-8.547008547,-23.05475504,-17.29106628,11.869436199999999,12,9,3,14,14,0,-2,-5,3,11,11,0,14,14,0,-3,-3,0,8,6,2,15,14,1,-7,-8,1,20,20,0,14,14,0,6,6,0,5,5,0,15,15,0,-10,-10,0,19,19,0,13,13,0,6,6,0,21,21,0,15,15,0,6,6,0,22,21,1,20,20,0,2,1,1,30,29,1,18,18,0,12,11,1,26.0,20.0,18.0,10.0,25.0,16.0,21.0,9.0,21.0,26.0,20.0,26.0,16.0,26.0,47.0,25.0,35.0,53.0,22.0,43.0,35.0,34.0,37.0,39.0,37.0,42.0,23.0,36.0,32.0,47.0,36.0,35.0,54.0,47.0,42.0,38.0,21.0,47.0,39.0,49.0,39.0,66.0,41.0,47.0,58.0,30.0,52.0,46.0,36.0,41.0,33.0,28.0,19.0,15.0,7.0,4.0,4.0,0.0,0.0,1.0,0.0,0.0,0.0,14.0,10.0,6.0,4.0,11.0,8.0,14.0,1.0,12.0,14.0,14.0,10.0,5.0,11.0,17.0,18.0,14.0,27.0,10.0,20.0,20.0,18.0,21.0,24.0,17.0,26.0,15.0,22.0,20.0,30.0,20.0,24.0,30.0,29.0,21.0,16.0,17.0,20.0,14.0,21.0,14.0,36.0,18.0,27.0,30.0,10.0,28.0,21.0,14.0,19.0,12.0,14.0,7.0,5.0,1.0,1.0,0.0,0.0,0.0,0.0,0.0,0.0,0.0,12.0,10.0,12.0,6.0,14.0,8.0,7.0,8.0,9.0,12.0,6.0,16.0,11.0,15.0,30.0,7.0,21.0,26.0,12.0,23.0,15.0,16.0,16.0,15.0,20.0,16.0,8.0,14.0,12.0,17.0,16.0,11.0,24.0,18.0,21.0,22.0,4.0,27.0,25.0,28.0,25.0,30.0,23.0,20.0,28.0,20.0,24.0,25.0,22.0,22.0,21.0,14.0,12.0,10.0,6.0,3.0,4.0,0.0,0.0,1.0,0.0,0.0,0.0,8.100147275,8.780487805,10.40145985,119,29,106,32,113,25,104,26,106,22,113,32,54,57,223,202,191,32.84241532,32.84552846,34.8540146,96.24277457,100.9803922,104.4776119,401,359,300,59.05743741,58.37398374,54.74452555,110.6109726,110.2674095,120.66666670000001,55.61097257,56.26740947,63.66666667,405.4545455,374.0740741,335.0877193,7607,1120.324006,25.04065041,154,23.54014599,129,150.0,235.0,80.76923077,32.65895954,113,15.92920354,66.33986928,203,9.852216749,30.59701493,82,31.70731707,10.61946903,4.926108374,14.63414634,30832.35973,43984852.5,548.0,534.0,538.0,539.0,536.0,556.0,560.0,576.0,583.0,603.0,607.0,615.0,614.0,634.0,647.0,660.0,664.0,664.0,679.0,678.0,692.0,682.0,690.0,707.0,714.5,722.0,803.0,893.0,1084.0,1264.0,1224.0,1220.0,1221.0,1058.0,1050.0,1002.0,43.98485184,22.78057009,23.87185488,24.05373568,27.75955696,27.73682186,27.82776226,28.73716626,24.64484828,20.302444199999996,18.25628521,16.41474212,16.24422887,16.07371562,15.68721892,15.50533812,15.73268912,15.41439772,15.43713282,15.09610632,15.09610632,15.00516592,14.70960963,14.41405333,13.95935133,13.98208643,13.80020563,13.70926523,13.25456323,13.09541753,12.73165594,12.64071554,12.18601354,12.25421884,12.23148374,12.14054334,12.45883474,0,0,0,0,2,16228.54613,4401.571867000001,6275.446322,6488.339818,3260.063686,3,15,0.00298776,0,0.13,0.0,1.0,1.0
39022,2407,Cantabria,Cantabria,Cillorigo de Li√©bana,172,2382,2210,937.1286060000001,470.97467400000005,0.346717,65.327324,64.98060600000001,23.319627,10.036978999999999,35864.041860000005,54447.82402000001,18583.78216,45434.70633,4409.629406,14.647549,10871.19334,10856.54579,3642.5763490000004,2514.9102510000002,16081.374119999999,25612.1709,9530.796779,20825.71379,2011.47983,15148.29008,25485.28833,10336.99824,20187.13471,2201.146303,5.0,11.0,10.0,7.0,11.0,15.0,6,14,6,9,4,15,11,9,12,9,8,6,6,15,5,13.0,18.0,8.0,13.0,11.0,22.0,16,13,13,9,8,14,11,14,15,11,12,10,16,9,17,-8,-7,2,-6,0,-7,-10,1,-7,0,-4,1,0,-5,-3,-2,-4,-4,-10,6,-12,3.909304144,8.681925809,7.874015748,5.537974684,8.906882591,12.25490196,4.926108374,11.47540984,4.94641385,7.468879668,3.336113428,12.84246575,9.47459087,7.978723404,10.66666667,8.14479638,7.359705612000001,5.519779209,5.581395349,14.03180543,4.659832246000001,10.16419077,14.20678769,6.299212598,10.28481013,8.906882591,17.97385621,13.136289000000001,10.6557377,10.71723001,7.468879668,6.672226856,11.98630137,9.47459087,12.41134752,13.33333333,9.954751131,11.02941176,9.199632015,14.88372093,8.419083255,15.84342964,-6.25488663,-5.524861878,1.57480315,-4.746835443,0,-5.718954248,-8.210180624,0.8196721309999999,-5.770816158,0.0,-3.336113428,0.8561643840000001,0.0,-4.432624113,-2.666666667,-1.809954751,-3.676470588,-3.6798528060000004,-9.302325581,5.61272217,-11.18359739,54,46,8,49,39,10,5,7,-2,75,68,7,61,52,9,14,16,-2,73,65,8,87,81,6,-14,-16,2,67,61,6,75,64,11,-8,-3,-5,79,57,22,60,54,6,19,3,16,84,67,17,59,52,7,25,15,10,68,52,16,83,72,11,-15,-20,5,86,62,24,95,90,5,-9,-28,19,78,68,10,59,50,9,19,18,1,40.0,55.0,42.0,51.0,60.0,40.0,49.0,56.0,54.0,68.0,66.0,60.0,51.0,65.0,71.0,59.0,90.0,79.0,56.0,95.0,71.0,108.0,104.0,81.0,87.0,98.0,105.0,103.0,118.0,78.0,110.0,100.0,68.0,121.0,81.0,44.0,106.0,72.0,54.0,67.0,58.0,51.0,78.0,42.0,79.0,48.0,76.0,62.0,37.0,53.0,55.0,33.0,31.0,27.0,22.0,17.0,18.0,4.0,8.0,4.0,1.0,0.0,1.0,20.0,32.0,17.0,23.0,29.0,21.0,27.0,27.0,31.0,34.0,36.0,38.0,28.0,40.0,37.0,33.0,46.0,46.0,28.0,57.0,35.0,48.0,52.0,40.0,50.0,48.0,61.0,52.0,70.0,44.0,59.0,57.0,46.0,64.0,47.0,27.0,62.0,45.0,30.0,38.0,37.0,29.0,46.0,20.0,40.0,28.0,42.0,30.0,16.0,25.0,29.0,18.0,12.0,10.0,5.0,9.0,6.0,2.0,3.0,0.0,0.0,0.0,0.0,20.0,23.0,25.0,28.0,31.0,19.0,22.0,29.0,23.0,34.0,30.0,22.0,23.0,25.0,34.0,26.0,44.0,33.0,28.0,38.0,36.0,60.0,52.0,41.0,37.0,50.0,44.0,51.0,48.0,34.0,51.0,43.0,22.0,57.0,34.0,17.0,44.0,27.0,24.0,29.0,21.0,22.0,32.0,22.0,39.0,20.0,34.0,32.0,21.0,28.0,26.0,15.0,19.0,17.0,17.0,8.0,12.0,2.0,5.0,4.0,1.0,0.0,1.0,11.88811189,12.71375465,10.77752117,153,67,137,83,137,70,144,69,137,88,137,70,171,140,297,285,290,25.96153846,21.18959108,22.32486528,117.0777989,120.13093290000002,110.19417479999998,711,889,869,62.15034965,66.09665428,66.89761355,177.7721519,203.0584927,173.3716916,41.7721519,32.05849269,33.371691600000005,218.3823529,166.66666669999998,207.1428571,175,15.297202800000003,30.85501859,415,27.251732099999998,354,90.0,109.0909091,155.8823529,48.76660342,257,16.34241245,84.77905074,518,10.61776062,35.760517799999995,221,18.09954751,9.727626459,4.44015444,9.049773756,56952.47771,106456612.1,1299.0,1299.0,1305.0,1337.0,1320.0,1310.0,1318.0,1345.0,1339.0,1338.0,1336.0,1345.0,1305.0,1290.0,1221.0,1215.0,1179.0,1195.0,1144.0,1122.0,1085.0,1103.0,1111.0,1135.0,1150.5,1166.0,1042.0,1347.0,1656.0,1888.0,2350.0,2439.0,2214.0,2353.0,2039.0,2476.0,106.45661159999999,23.25830178,19.15334303,22.10290149,20.79720523,22.91074234,22.074721,17.73492478,15.55563318,12.65304221,9.788025225,10.95281901,10.80721979,10.66162057,10.43617661,10.36102862,10.19194565,10.53950509,10.74616205,11.22523046,11.07493449,11.41310043,11.46946142,12.117612800000002,12.25851528,12.63425521,12.54971372,12.56850072,12.57789422,12.63425521,12.38063075,12.30548277,12.39941775,12.55910722,12.25851528,12.20215429,12.20215429,0,1,0,0,2,45347.00512,7597.7785650000005,6987.134736,7045.4906599999995,3259.163146,58,306,4.49142e-05,0,0.0,0.0,1.0,1.0
39023,2408,Cantabria,Cantabria,Colindres,-2,312,314,71.61219799999999,93.07543199999999,0.0,25.834288,25.834288,5.825813,6.072495,2247.935462,4329.480366,2081.544904,3368.453915,468.252062,25.735528,1484.105031,1458.369503,699.831845,323.953152,51.846025,3524.8925719999997,3473.046548,1766.158545,866.8624179999999,419.178058,3439.615054,3020.436996,2074.49575,727.103869,79.0,83.0,73.0,101.0,95.0,96.0,88,79,93,91,81,80,74,81,78,80,57,69,75,52,45,44.0,41.0,50.0,37.0,42.0,53.0,38,55,51,40,45,44,58,39,63,55,56,71,60,58,74,35,42,23,64,53,43,50,24,42,51,36,36,16,42,15,25,1,-2,15,-6,-29,163.2231405,175.4756871,158.008658,223.4513274,225.1184834,227.4881517,212.04819280000004,195.0617284,234.256927,234.53608250000002,218.91891890000002,223.4636872,212.64367819999995,235.4651163,232.83582090000002,245.398773,180.37974680000002,218.3544304,244.29967430000002,173.91304350000001,265.993266,90.90909091,86.6807611,108.2251082,81.85840708,99.52606635,125.5924171,91.56626506,135.8024691,128.46347609999998,103.0927835,121.6216216,122.90502790000001,166.66666669999998,113.37209299999999,188.0597015,168.7116564,173.91304350000001,224.6835443,195.4397394,193.9799331,249.1582492,72.31404959,88.794926,49.78354978,141.5929204,125.5924171,101.8957346,120.4819277,59.25925926,105.79345090000001,131.443299,97.2972973,100.55865920000001,45.97701149,122.0930233,44.7761194,76.68711656,3.105590062,-6.329113924,48.85993485,-20.06688963,-97.64309764,510,469,41,374,346,28,136,123,13,373,332,41,434,365,69,-61,-33,-28,418,377,41,435,398,37,-17,-21,4,434,388,46,408,374,34,26,14,12,390,349,41,432,363,69,-42,-14,-28,553,471,82,377,328,49,176,143,33,484,375,109,461,418,43,23,-43,66,557,407,150,438,400,38,119,7,112,380,324,56,443,383,60,-63,-59,-4,316.0,453.0,366.0,429.0,457.0,328.0,480.0,415.0,378.0,510.0,387.0,376.0,442.0,415.0,501.0,372.0,473.0,664.0,446.0,702.0,698.0,534.0,797.0,684.0,732.0,741.0,530.0,841.0,576.0,435.0,710.0,511.0,443.0,581.0,393.0,370.0,533.0,414.0,279.0,391.0,331.0,300.0,418.0,285.0,197.0,304.0,219.0,198.0,226.0,171.0,114.0,156.0,95.0,51.0,63.0,28.0,27.0,17.0,6.0,5.0,3.0,3.0,1.0,156.0,260.0,184.0,239.0,245.0,176.0,260.0,200.0,185.0,271.0,187.0,192.0,232.0,217.0,264.0,194.0,238.0,310.0,228.0,341.0,346.0,252.0,379.0,353.0,365.0,373.0,280.0,401.0,302.0,215.0,334.0,273.0,229.0,296.0,176.0,191.0,257.0,216.0,136.0,173.0,167.0,154.0,206.0,139.0,98.0,137.0,102.0,89.0,102.0,70.0,42.0,65.0,32.0,15.0,30.0,11.0,8.0,5.0,2.0,1.0,0.0,0.0,0.0,160.0,193.0,182.0,190.0,212.0,152.0,220.0,215.0,193.0,239.0,200.0,184.0,210.0,198.0,237.0,178.0,235.0,354.0,218.0,361.0,352.0,282.0,418.0,331.0,367.0,368.0,250.0,440.0,274.0,220.0,376.0,238.0,214.0,285.0,217.0,179.0,276.0,198.0,143.0,218.0,164.0,146.0,212.0,146.0,99.0,167.0,117.0,109.0,124.0,101.0,72.0,91.0,63.0,36.0,33.0,17.0,19.0,12.0,4.0,4.0,3.0,3.0,1.0,15.43556515,16.83180894,14.40498589,486,527,615,620,860,570,407,545,615,705,860,655,1325,1225,893,1138,1578,12.85817135,14.45630081,18.55597366,99.74115617,99.69558599999999,97.72146013,4980,5409,5701,71.7062635,68.71189024,67.03904045,1089.931727,1346.039009,1252.6793539999999,17.93172691,21.03900906,27.6793545,83.30223881,85.88679245,128.8163265,692,9.96400288,35.77235772,2816,30.02116651,2553,74.20212766,106.9767442,104.50980390000001,50.18694277,1745,20.97421203,89.16793506,3515,12.88762447,35.85212741,1542,20.49286641,10.42979943,5.490753912000001,10.37613489,13650.39395,5951238.808999999,8504.0,8598.0,8484.0,8453.0,8288.0,8331.0,8271.0,8272.0,8307.0,8140.0,7948.0,7872.0,7826.0,7677.0,7490.0,7368.0,7235.0,7075.0,6945.0,6911.0,6786.0,6577.0,6420.0,6140.0,6119.5,6099.0,5536.0,4885.0,3320.0,2209.0,2000.0,1824.0,1560.0,1497.0,1325.0,1189.0,5.951238632000001,199.7903417,222.64272730000002,251.54427379999998,262.1303054,306.4908186,336.0644941,371.18323369999996,557.8670602000001,820.8375268,930.2265196000001,1024.828675,1028.273336,1031.717997,1078.767026,1105.148089,1140.266828,1161.270859,1166.983956,1188.828148,1215.713307,1238.061596,1258.5615300000002,1289.98356,1315.020365,1322.749849,1335.520299,1367.782491,1395.843876,1389.962747,1389.794715,1399.87665,1392.651263,1420.376584,1425.585584,1444.74126,1428.946229,0,3,12,1,1,2988.188744,8363.11942,1289.726336,1591.9388800000002,1382.50779,12,50,0.023982728,0,1.0,1.0,1.0,1.0
39024,2409,Cantabria,Cantabria,Comillas,-2,307,309,77.89335799999999,59.237262,0.17336,24.702366,24.529006,9.003142,4.812208999999999,16890.89049,22642.335880000002,5751.445389,20150.77133,1126.348032,2324.43436,6882.028986,4557.594626,4599.578896,1032.137562,1359.115339,7092.85127,5733.735931,4169.894774,1367.403654,2515.226927,8511.051986,5995.825059000001,5481.572719,1390.830371,17.0,21.0,10.0,13.0,12.0,14.0,15,13,20,14,18,19,18,17,14,22,13,8,9,12,6,41.0,46.0,34.0,33.0,43.0,42.0,44,42,38,38,36,30,40,22,39,51,41,28,32,26,25,-24,-25,-24,-20,-31,-28,-29,-29,-18,-24,-18,-11,-22,-5,-25,-29,-28,-20,-23,-14,-19,57.23905724,71.91780822,34.12969283,45.77464789,43.01075269,51.28205128,55.55555556,50.19305019,80.64516129,56.68016194,73.77049179999999,81.89655172,82.56880734,81.73076923,70.35175879,111.67512690000001,69.51871658,42.78074866,48.91304348,67.79661017,97.14285714,138.047138,157.5342466,116.0409556,116.1971831,154.1218638,153.8461538,162.962963,162.1621622,153.2258065,153.84615380000002,147.54098359999998,129.3103448,183.4862385,105.7692308,195.97989950000002,258.88324869999997,216.9312169,149.7326203,173.91304350000001,146.8926554,142.8571429,-80.80808081,-85.61643836,-81.9112628,-70.42253521,-111.1111111,-102.5641026,-107.4074074,-111.96911200000001,-72.58064516,-97.16599190000001,-73.77049179999999,-47.41379310000001,-100.91743120000001,-24.03846154,-125.62814070000002,-147.20812180000001,-148.1481481,-106.9518717,-125.0,-79.0960452,-108.57142859999999,102,88,14,112,101,11,-10,-13,3,68,57,11,127,107,20,-59,-50,-9,77,65,12,100,87,13,-23,-22,-1,81,68,13,75,68,7,6,0,6,92,74,18,96,87,9,-4,-13,9,95,73,22,111,94,17,-16,-21,5,101,72,29,85,84,1,16,-12,28,111,93,18,92,86,6,19,7,12,111,101,10,80,75,5,31,26,5,40.0,76.0,59.0,85.0,78.0,79.0,70.0,75.0,100.0,67.0,102.0,121.0,77.0,127.0,150.0,97.0,158.0,159.0,93.0,184.0,178.0,136.0,179.0,156.0,166.0,176.0,171.0,148.0,185.0,149.0,178.0,174.0,159.0,164.0,166.0,143.0,172.0,171.0,107.0,155.0,140.0,163.0,157.0,133.0,127.0,99.0,123.0,138.0,96.0,114.0,72.0,67.0,66.0,54.0,39.0,26.0,16.0,10.0,7.0,10.0,1.0,2.0,0.0,20.0,44.0,31.0,46.0,37.0,41.0,39.0,40.0,50.0,31.0,52.0,61.0,42.0,62.0,77.0,44.0,93.0,80.0,49.0,94.0,104.0,81.0,88.0,76.0,77.0,90.0,78.0,67.0,84.0,71.0,96.0,81.0,82.0,73.0,81.0,68.0,76.0,84.0,58.0,80.0,66.0,77.0,68.0,61.0,52.0,39.0,56.0,48.0,36.0,36.0,22.0,24.0,18.0,8.0,10.0,2.0,4.0,2.0,1.0,3.0,0.0,1.0,0.0,20.0,32.0,28.0,39.0,41.0,38.0,31.0,35.0,50.0,36.0,50.0,60.0,35.0,65.0,73.0,53.0,65.0,79.0,44.0,90.0,74.0,55.0,91.0,80.0,89.0,86.0,93.0,81.0,101.0,78.0,82.0,93.0,77.0,91.0,85.0,75.0,96.0,87.0,49.0,75.0,74.0,86.0,89.0,72.0,75.0,60.0,67.0,90.0,60.0,78.0,50.0,43.0,48.0,46.0,29.0,24.0,12.0,8.0,6.0,7.0,1.0,1.0,0.0,10.29857205,9.301380991,9.211147851,366,116,370,108,365,90,214,122,370,121,365,105,229,195,580,611,624,25.09736045,24.81722177,29.47567312,89.42622951,90.70487994,89.52551477,1493,1622,1298,64.6040675,65.88139724,61.31317903,276.84795710000003,266.6695438,243.0739599,38.84795713,37.66954377,48.07395994,243.69747900000002,266.8122271,320.0,2061,89.18217222,29.40698619,724,25.64950402,543,88.42975207,167.64705880000002,256.7164179,39.01639344,476,12.39495798,71.72734314,926,8.207343413,29.00626679,324,12.34567901,5.882352941000001,3.455723542,6.172839506,21243.131680000002,18474592.67,2117.0,2124.0,2141.0,2156.0,2195.0,2228.0,2267.0,2320.0,2374.0,2439.0,2425.0,2462.0,2464.0,2483.0,2467.0,2469.0,2431.0,2373.0,2311.0,2340.0,2336.0,2359.0,2360.0,2330.0,2347.0,2364.0,2461.0,2397.0,2408.0,3234.0,3610.0,3589.0,3261.0,3106.0,3120.0,2754.0,18.47459221,149.06959619999998,168.88058830000003,168.1227907,176.5126918,194.2668049,195.4035012,175.05122509999998,130.341172,129.74575959999999,133.2099768,127.9595226,127.0393399,126.11915729999998,127.7430091,127.6888807,126.44392759999998,126.66044120000001,125.09071780000001,128.4466782,131.586125,133.643004,133.5347472,134.4008015,133.372362,133.26410520000002,131.2613547,132.0191522,128.50080659999998,125.57787330000001,122.7090685,120.59806110000001,118.8118241,116.70081680000001,115.88889089999999,114.9687082,114.58980940000001,0,1,0,0,1,17694.06324,9214.792249,3489.4100799999997,7652.313902,2118.877712,96,479,0.003521797,0,0.98,0.16,1.0,1.0
39025,2410,Cantabria,Cantabria,Corrales de Buelna (Los),55,782,727,299.315044,154.463862,0.0,48.114895000000004,48.114895000000004,13.711925,7.836697,5136.952593,13472.741869999998,8335.789273999999,9931.249567,1735.7526280000002,12.639192,6048.732546,6036.093354,2364.815039,1468.508509,7.905374,6010.376102,6002.470728,2580.0948399999997,1424.04829,36.624313,6648.544637,6611.920324000001,3123.726922,1520.2190970000001,114.0,98.0,101.0,107.0,97.0,113.0,131,112,137,124,116,108,113,85,88,77,58,73,65,52,55,99.0,87.0,101.0,93.0,100.0,116.0,103,93,106,100,86,108,106,93,105,84,101,109,114,124,118,15,11,0,14,-3,-3,28,19,31,24,30,0,7,-8,-17,-7,-43,-36,-49,-72,-63,81.1965812,71.9002201,74.64892831,80.20989505,75.36907537,90.4,108.35401159999999,94.67455621,114.54849499999999,103.50584309999999,98.05579036,92.94320138,99.12280702,77.76761208,82.4742268,73.75478927,58.11623246,73.14629259,66.53019447,54.27974948,123.64425159999999,70.51282051,63.82978723,74.64892831,69.71514243,77.7000777,92.8,85.19437552,78.613694,88.62876254,83.47245409,72.69653423,92.94320138,92.98245614,85.08691674,98.40674789,80.45977011,98.92262488,109.2184369,116.6837257,129.4363257,127.98264640000002,10.68376068,8.070432869,0,10.49475262,-2.331002331,-2.4,23.15963606,16.06086221,25.91973244,20.03338898,25.35925613,0.0,6.140350877,-7.319304666,-15.93252109,-6.7049808429999995,-42.11557297,-36.07214429,-50.15353122,-75.1565762,-68.329718,261,233,28,344,321,23,-83,-88,5,264,241,23,458,309,149,-194,-68,-126,243,205,38,374,338,36,-131,-133,2,283,252,31,331,287,44,-48,-35,-13,306,272,34,315,274,41,-9,-2,-7,361,301,60,310,290,20,51,11,40,342,301,41,398,349,49,-56,-48,-8,389,324,65,373,351,22,16,-27,43,369,325,44,391,330,61,-22,-5,-17,328.0,624.0,517.0,479.0,582.0,451.0,574.0,513.0,453.0,545.0,501.0,551.0,514.0,580.0,781.0,423.0,790.0,973.0,470.0,1080.0,1031.0,660.0,1039.0,912.0,910.0,979.0,783.0,971.0,833.0,674.0,915.0,697.0,680.0,784.0,665.0,620.0,689.0,679.0,437.0,612.0,485.0,593.0,601.0,464.0,549.0,430.0,487.0,415.0,356.0,346.0,263.0,301.0,193.0,122.0,108.0,66.0,47.0,29.0,19.0,18.0,4.0,0.0,2.0,166.0,334.0,257.0,248.0,306.0,227.0,292.0,248.0,237.0,275.0,258.0,301.0,252.0,307.0,403.0,221.0,403.0,498.0,234.0,540.0,522.0,329.0,550.0,481.0,457.0,509.0,420.0,504.0,438.0,328.0,446.0,374.0,336.0,403.0,321.0,318.0,354.0,303.0,215.0,287.0,247.0,281.0,260.0,199.0,261.0,200.0,221.0,196.0,136.0,143.0,99.0,99.0,61.0,40.0,30.0,16.0,11.0,7.0,6.0,2.0,0.0,0.0,0.0,162.0,290.0,260.0,231.0,276.0,224.0,282.0,265.0,216.0,270.0,243.0,250.0,262.0,273.0,378.0,202.0,387.0,475.0,236.0,540.0,509.0,331.0,489.0,431.0,453.0,470.0,363.0,467.0,395.0,346.0,469.0,323.0,344.0,381.0,344.0,302.0,335.0,376.0,222.0,325.0,238.0,312.0,341.0,265.0,288.0,230.0,266.0,219.0,220.0,203.0,164.0,202.0,132.0,82.0,78.0,50.0,36.0,22.0,13.0,16.0,4.0,0.0,2.0,13.07027226,14.79091378,12.90292441,1119,700,1167,831,1422,675,890,721,1167,888,1422,706,1719,1381,2009,2060,2441,18.47866078,17.725004300000002,22.80668971,99.88968559999999,99.07502569,94.49391241,7442,7843,6881,68.45106696,67.48408191,64.29038587,1447.995431,1745.26546,1416.474495,26.99543134,26.26545965,35.47449499,141.37931030000001,119.83711459999999,176.75597390000001,1179,10.84437086,33.82378248,3931,28.13229936,3011,79.31034483,135.5289421,126.42201829999999,48.26254826,2625,19.6952381,85.11476533,4969,12.55785872,32.12793022,1768,18.5520362,9.904761905,5.836184342999999,9.162895928,32735.9077,45226482.85,10703.0,10767.0,10841.0,10910.0,10912.0,11003.0,11077.0,11230.0,11448.0,11519.0,11623.0,11622.0,11610.0,11513.0,11223.0,11091.0,10958.0,10825.0,10872.0,10876.0,10847.0,10718.0,10657.0,10491.0,10390.0,10289.0,9820.0,10045.0,9307.0,8111.0,6185.0,5292.0,4871.0,3501.0,2926.0,2752.0,45.22648239,60.84930453,64.69660794,77.41039795,107.70238459999999,117.01109,136.7561586,179.3418274,205.78651059999999,222.10438369999997,217.12942239999998,227.49945290000002,229.7326577,231.9658626,235.6362785,236.98504580000002,239.8373569,240.4785742,240.3901304,239.35091630000002,242.2916712,245.2324261,248.15107000000003,254.5632424,256.7080035,256.97333480000003,256.9954457,254.695908,253.12603140000002,248.3058466,244.92287290000002,243.2866634,241.27456800000002,241.23034610000002,239.7046913,238.0684818,236.65338169999998,0,4,50,1,1,11549.883109999999,2119.814003,2491.531787,3447.7426579999997,2802.149137,13,78,0.000103933,0,0.98,0.1,1.0,1.0
39026,2411,Cantabria,Cantabria,Corvera de Toranzo,80,1054,974,444.97253,214.81168799999998,0.0,43.778137,43.778137,13.090492,7.287577000000001,10324.14063,22158.02125,11833.88061,16399.667390000002,3269.398284,6.503819999999999,4697.66281,4691.15899,1919.0341670000003,1207.684726,3715.36065,12651.88746,8936.526807,8661.740791,1765.2603649999999,5431.3930740000005,11691.823359999999,6260.430289,8348.737915,1319.955989,14.0,16.0,18.0,12.0,15.0,17.0,9,17,19,18,13,16,12,14,12,18,16,12,9,8,10,34.0,27.0,30.0,25.0,30.0,26.0,21,28,22,22,26,29,26,22,27,30,26,19,32,22,19,-20,-11,-12,-13,-15,-9,-12,-11,-3,-4,-13,-13,-14,-8,-15,-12,-10,-7,-23,-14,-9,32.48259861,38.83495146,45.91836735,31.41361257,40.8719346,48.43304843,26.62721893,53.125,58.28220859,55.21472393,40.12345679,50.47318612,39.47368421,46.97986577,42.25352113,64.0569395,58.60805861,43.95604396,34.74903475,33.19502075,59.57446809,78.8863109,65.53398058,76.53061224,65.44502618,81.74386921,74.07407407,62.13017751,87.5,67.48466258,67.48466258,80.24691358,91.48264984,85.52631579,73.82550336,95.07042254,106.7615658,97.01492537,69.5970696,123.5521236,91.28630705,80.85106383,-46.4037123,-26.69902913,-30.6122449,-34.03141361,-40.8719346,-25.64102564,-35.50295858,-34.375,-9.202453988,-12.26993865,-40.12345679,-41.00946372,-46.05263158,-26.84563758,-52.81690141,-42.70462633,-37.31343284,-25.64102564,-88.8030888,-58.09128631,-38.29787234,95,90,5,66,66,0,29,24,5,71,69,2,97,95,2,-26,-26,0,54,54,0,81,79,2,-27,-25,-2,65,60,5,67,60,7,-2,0,-2,62,55,7,75,74,1,-13,-19,6,68,67,1,67,64,3,1,3,-2,93,85,8,77,70,7,16,15,1,101,91,10,84,81,3,17,10,7,124,116,8,93,91,2,31,25,6,50.0,79.0,88.0,89.0,82.0,71.0,89.0,82.0,98.0,79.0,104.0,102.0,74.0,102.0,157.0,86.0,154.0,178.0,111.0,205.0,179.0,130.0,160.0,150.0,184.0,152.0,158.0,167.0,179.0,132.0,165.0,139.0,148.0,163.0,140.0,105.0,145.0,116.0,113.0,119.0,110.0,116.0,114.0,101.0,122.0,88.0,110.0,116.0,80.0,88.0,90.0,73.0,63.0,37.0,36.0,22.0,20.0,12.0,5.0,1.0,0.0,1.0,2.0,24.0,40.0,41.0,50.0,41.0,36.0,45.0,39.0,45.0,34.0,46.0,56.0,34.0,57.0,80.0,46.0,81.0,94.0,61.0,111.0,98.0,68.0,84.0,86.0,97.0,80.0,91.0,91.0,112.0,69.0,81.0,71.0,78.0,101.0,82.0,53.0,72.0,60.0,57.0,67.0,53.0,51.0,55.0,43.0,59.0,33.0,49.0,56.0,35.0,36.0,27.0,25.0,20.0,12.0,11.0,5.0,6.0,3.0,0.0,0.0,0.0,1.0,0.0,26.0,39.0,47.0,39.0,41.0,35.0,44.0,43.0,53.0,45.0,58.0,46.0,40.0,45.0,77.0,40.0,73.0,84.0,50.0,94.0,81.0,62.0,76.0,64.0,87.0,72.0,67.0,76.0,67.0,63.0,84.0,68.0,70.0,62.0,58.0,52.0,73.0,56.0,56.0,52.0,57.0,65.0,59.0,58.0,63.0,55.0,61.0,60.0,45.0,52.0,63.0,48.0,43.0,25.0,25.0,17.0,14.0,9.0,5.0,1.0,0.0,0.0,2.0,11.77278974,11.07566089,11.10029211,293,135,293,123,293,109,211,122,293,120,293,119,243,228,504,500,522,23.08749427,22.78942571,25.41382668,100.64338240000001,102.5854109,101.1753183,1422,1451,1304,65.13971599,66.1349134,63.48588121,292.443038,277.45899380000003,268.0306748,35.44303797,34.458993799999995,40.03067485,196.1089494,205.7613169,228.9473684,2858,130.9207513,31.72288058,696,28.821811100000005,592,110.78431370000001,111.5384615,183.54430380000002,46.41544118,505,17.42574257,80.9787627,877,9.007981756,33.3006856,340,14.70588235,9.306930693,4.446978335,7.647058824,37637.286830000005,49994212.04,2054.0,2042.0,2039.0,2041.0,2055.0,2074.0,2080.0,2121.0,2165.0,2159.0,2191.0,2194.0,2208.0,2202.0,2199.0,2199.0,2221.0,2184.0,2183.0,1937.0,2017.0,2046.0,2102.0,2141.0,2166.5,2192.0,2120.0,2508.0,2607.0,2893.0,3105.0,3013.0,2945.0,2962.0,2943.0,2884.0,49.994213099999996,57.68667654,58.86681312,59.24685711,58.90681775,60.26697517,62.10718816,57.86669737,52.14603527,50.16580609,42.40490786,43.84507454,43.335015500000004,42.82495647,42.04486619,40.92473654,40.34466941,38.74448421,43.6650537,43.68505602,44.42514167,43.98509074,43.98509074,44.04509769,44.16511158,43.88507917,43.82507222,43.18499814,43.30501203,42.42491017,41.60481525,41.48480136,41.10475738,40.82472497,40.78472034,40.84472728,41.08475506,0,1,0,1,2,19620.15234,9098.659748999999,9065.916497,4097.863908,2288.4705480000002,12,58,0.13629082,0,0.1,0.1,1.0,1.0
39027,2412,Cantabria,Cantabria,Campoo de Enmedio,702,1439,737,976.2129890000001,136.08290300000002,0.0,34.526546,34.526546,9.379957000000001,6.511628,637.391919,9486.587212,8849.195293,4753.581507,2045.2036920000003,11.437139,5708.221043,5696.7839030000005,2272.772098,1212.461555,16.376935,4805.331281000001,4788.954346,2026.39633,1069.265203,71.5341,6080.875368,6009.341268,3361.525856,1153.9150300000001,28.0,22.0,25.0,28.0,36.0,27.0,31,25,20,21,33,37,35,29,24,39,37,33,32,28,21,22.0,44.0,37.0,45.0,35.0,29.0,34,25,31,33,23,26,35,39,47,34,37,40,37,41,38,6,-22,-12,-17,1,-2,-3,0,-11,-12,10,11,0,-10,-23,5,0,-7,-5,-13,-17,44.58598726,35.88907015,42.22972973,48.44290657,64.40071556,50.27932961,59.16030534,48.73294347,40.16064257,43.65904366,69.91525424,78.72340426,75.10729614,64.15929204,53.45211581,91.33489461,91.81141439,81.88585608,81.01265823,74.07407407,78.43137255,35.03184713,71.77814029,62.5,77.85467128,62.6118068,54.00372439,64.88549618,48.73294347,62.24899598,68.60706861,48.72881356,55.31914894,75.10729614,86.28318584,104.67706009999999,79.62529274,88.72901679,99.25558313,93.67088608,108.4656085,106.442577,9.554140127,-35.88907015,-20.27027027,-29.41176471,1.788908766,-3.724394786,-5.72519084,0.0,-22.08835341,-24.94802495,21.18644068,23.40425532,0.0,-22.12389381,-51.22494432,11.70960187,0.0,-17.36972705,-12.65822785,-34.39153439,-47.61904762,148,142,6,142,138,4,6,4,2,135,124,11,130,115,15,5,9,-4,141,134,7,133,125,8,8,9,-1,141,134,7,135,132,3,6,2,4,112,103,9,129,118,11,-17,-15,-2,105,95,10,104,101,3,1,-6,7,124,119,5,145,141,4,-21,-22,1,127,108,19,126,119,7,1,-11,12,139,134,5,126,124,2,13,10,3,153.0,149.0,124.0,179.0,144.0,118.0,165.0,117.0,157.0,155.0,150.0,224.0,125.0,172.0,313.0,150.0,277.0,379.0,145.0,345.0,270.0,271.0,308.0,258.0,330.0,245.0,310.0,322.0,249.0,332.0,232.0,314.0,326.0,238.0,302.0,246.0,286.0,270.0,159.0,284.0,190.0,203.0,245.0,146.0,207.0,152.0,192.0,181.0,112.0,135.0,92.0,101.0,76.0,67.0,35.0,25.0,23.0,11.0,7.0,7.0,1.0,0.0,0.0,79.0,82.0,66.0,104.0,75.0,63.0,88.0,60.0,73.0,82.0,73.0,122.0,64.0,95.0,165.0,74.0,158.0,187.0,76.0,178.0,147.0,134.0,169.0,137.0,169.0,131.0,165.0,170.0,133.0,181.0,132.0,170.0,161.0,122.0,163.0,140.0,147.0,132.0,77.0,144.0,108.0,112.0,113.0,71.0,99.0,77.0,86.0,84.0,41.0,56.0,40.0,48.0,31.0,25.0,9.0,6.0,2.0,3.0,1.0,2.0,0.0,0.0,0.0,74.0,67.0,58.0,75.0,69.0,55.0,77.0,57.0,84.0,73.0,77.0,102.0,61.0,77.0,148.0,76.0,119.0,192.0,69.0,167.0,123.0,137.0,139.0,121.0,161.0,114.0,145.0,152.0,116.0,151.0,100.0,144.0,165.0,116.0,139.0,106.0,139.0,138.0,82.0,140.0,82.0,91.0,132.0,75.0,108.0,75.0,106.0,97.0,71.0,79.0,52.0,53.0,45.0,42.0,26.0,19.0,21.0,8.0,6.0,5.0,1.0,0.0,0.0,9.984984985,10.75268817,13.46153846,416,197,412,193,506,226,364,202,412,217,506,271,410,497,780,771,941,19.51951952,20.22029898,25.48754063,105.1334702,107.7929155,103.30396479999999,2817,2632,2254,70.49549549999999,69.02701285,61.05092091,426.6890308999999,439.2933131,538.7480035,27.68903088,29.29331307,41.74800355,195.4887218,188.0487805,189.3360161,819,20.495495499999997,30.08130081,1147,28.92741062,1068,70.98214286,180.0,184.516129,47.38193018,923,13.43445287,81.58038147,1497,9.953239813,32.9845815,599,25.54257095,6.283856987999999,4.475617902,12.35392321,61260.22159,91096944.1,3692.0,3696.0,3714.0,3750.0,3757.0,3778.0,3780.0,3795.0,3802.0,3798.0,3792.0,3813.0,3811.0,3862.0,3902.0,3932.0,3967.0,3959.0,3996.0,3995.0,4002.0,3972.0,3897.0,3866.0,3862.0,3858.0,3869.0,4037.0,3887.0,4621.0,4499.0,4162.0,4542.0,3271.0,2787.0,2695.0,91.09694672,29.58386749,30.59378059,35.90680169,49.85897073,45.68759053,49.38694613,50.72617872,42.66882854,44.31542599,42.47123685,42.35048637,42.39439563,42.4383049,42.7786017,43.60190043,43.93121992,43.8543787,43.86535602,43.45919532,43.54701385,43.16280777,42.83348829,42.39439563,41.8345525,41.85650713,41.62598349,41.69184739,41.73575665,41.65891544,41.49425569,41.47230106,41.24177742,41.1649362,40.76975282,40.57216112,40.52825186,0,0,0,0,1,41384.4779,3798.549953,4427.385268,4596.743851,3776.479906,5,49,0.004567729,0,0.0,0.0,1.0,1.0
39056,2413,Cantabria,Cantabria,Puente Viesgo,30,792,762,270.84565699999996,174.975854,0.0,44.628407,44.628407,12.56062,7.293903,3511.31455,11541.37168,8030.05713,7787.4992170000005,1955.093542,10.055356,4423.679781,4413.624425,1597.482559,1083.931251,53.464962,7455.811412999999,7402.346451,3617.5573640000002,1828.3496910000001,2106.935415,8796.024607,6689.089192,5601.901723,1548.840116,12.0,16.0,14.0,23.0,20.0,22.0,26,24,27,30,36,33,28,34,23,24,24,32,19,20,12,31.0,20.0,35.0,20.0,22.0,31.0,24,25,23,26,29,38,32,36,28,38,35,33,30,23,39,-19,-4,-21,3,-2,-9,2,-1,4,4,7,-5,-4,-2,-5,-14,-11,-1,-11,-3,-27,6.932409012,9.478672986,8.348240906,14.06727829,12.31527094,13.55514479,16.08910891,14.53664446,16.30434783,18.03968731,22.16748768,20.24539877,17.39130435,21.37020742,14.82914249,15.75837163,15.98934044,21.31912059,12.5082291,13.55932203,8.236101579,17.90872328,11.84834123,20.87060227,12.2324159,13.54679803,19.1004313,14.85148515,15.14233798,13.88888889,15.63439567,17.85714286,23.31288344,19.8757764,22.62727844,18.05286912,24.95075509,22.90575916,21.9853431,19.74983542,15.59322034,26.76733013,-10.97631427,-2.369668246,-12.52236136,1.834862385,-1.231527094,-5.545286506,1.2376237620000001,-0.605693519,2.415458937,2.405291642,4.310344828,-3.067484663,-2.48447205,-1.257071025,-3.223726628,-9.192383454,-7.19895288,-0.666222518,-7.24160632,-2.033898305,-18.53122855,89,87,2,119,111,8,-30,-24,-6,101,98,3,97,97,0,4,1,3,157,157,0,111,111,0,46,46,0,104,98,6,102,96,6,2,2,0,101,99,2,118,116,2,-17,-17,0,127,123,4,97,91,6,30,32,-2,132,127,5,132,124,8,0,3,-3,113,97,16,116,108,8,-3,-11,8,177,174,3,98,94,4,79,80,-1,108.0,145.0,84.0,172.0,103.0,81.0,172.0,92.0,101.0,130.0,109.0,133.0,94.0,157.0,240.0,91.0,255.0,206.0,145.0,295.0,169.0,216.0,200.0,167.0,317.0,210.0,187.0,243.0,183.0,171.0,197.0,205.0,168.0,193.0,181.0,132.0,196.0,150.0,92.0,178.0,103.0,110.0,144.0,109.0,153.0,95.0,115.0,118.0,84.0,99.0,76.0,77.0,62.0,46.0,34.0,30.0,15.0,14.0,3.0,3.0,2.0,1.0,1.0,60.0,85.0,41.0,97.0,54.0,43.0,91.0,49.0,44.0,66.0,56.0,81.0,47.0,78.0,133.0,50.0,140.0,120.0,72.0,161.0,88.0,105.0,113.0,75.0,172.0,106.0,99.0,129.0,89.0,87.0,98.0,107.0,92.0,98.0,89.0,65.0,102.0,82.0,41.0,87.0,47.0,53.0,71.0,52.0,79.0,44.0,52.0,46.0,30.0,44.0,29.0,27.0,21.0,18.0,15.0,6.0,5.0,2.0,0.0,1.0,1.0,0.0,0.0,48.0,60.0,43.0,75.0,49.0,38.0,81.0,43.0,57.0,64.0,53.0,52.0,47.0,79.0,107.0,41.0,115.0,86.0,73.0,134.0,81.0,111.0,87.0,92.0,145.0,104.0,88.0,114.0,94.0,84.0,99.0,98.0,76.0,95.0,92.0,67.0,94.0,68.0,51.0,91.0,56.0,57.0,73.0,57.0,74.0,51.0,63.0,72.0,54.0,55.0,47.0,50.0,41.0,28.0,19.0,24.0,10.0,12.0,3.0,2.0,1.0,1.0,1.0,10.84386466,12.112575699999999,15.5754652,291,138,300,152,351,204,231,128,300,188,351,248,340,452,522,522,628,21.28006523,18.59636623,21.640248100000004,102.2258862,103.997093,101.80806679999999,1665,1945,1822,67.87607012,69.29105807,62.78428670000001,297.3513514,366.8380463,486.46761799999996,31.35135135,26.83804627,34.467618,196.2406015,153.5294118,138.9380531,1009,41.13330616,31.63519772,888,31.73673329,921,69.17293233,137.6146789,150.76923080000003,49.13437758,596,14.09395973,89.09883721,1226,11.82707993,35.60500695,512,21.09375,7.214765101,4.893964111,9.375,31293.71737,35905364.66,2902.0,2845.0,2854.0,2868.0,2843.0,2877.0,2886.0,2851.0,2843.0,2861.0,2846.0,2807.0,2746.0,2685.0,2651.0,2522.0,2464.0,2506.0,2453.0,2344.0,2333.0,2358.0,2378.0,2314.0,2311.0,2308.0,2464.0,2497.0,2550.0,2810.0,2569.0,2504.0,2320.0,2102.0,2003.0,1972.0,35.90536499,54.92215441,55.78553513,58.54278325,64.6142993,69.73888166,71.54919608,78.26128493,71.02002725,69.54392472,68.62484202,64.28008741,64.36364038,64.44719335,66.22965678,65.67263696,64.97636219,65.28272309,68.31848111,69.79458364,68.62484202,70.2401995,73.83297735,74.77991104,76.4788215,78.17773196,79.26392061,79.68168547,79.18036764,79.40317556,80.37796025,80.12730133,79.18036764,79.87664241,79.48672854,79.23606962,80.82357611,0,1,2,0,2,11110.76706,8194.834573,3370.587994,6349.672865,2140.18334,7,36,0.002634589,0,0.91,0.09,1.0,1.0
39028,2414,Cantabria,Cantabria,Entrambasaguas,9,552,543,156.320665,112.358848,0.0,32.958694,32.958694,9.332162,6.361671,7187.333034,17991.86905,10804.53602,12834.37171,2895.783156,12.705902,9246.426737,9233.720835,3417.8583020000005,2263.441389,40.457567,8847.343461,8806.885894,3543.491365,1953.078791,124.20233999999999,7776.454547,7652.2522069999995,3596.160757,1988.76465,22.0,18.0,29.0,20.0,28.0,40.0,39,52,68,70,81,99,79,85,73,68,58,52,59,44,50,39.0,31.0,18.0,22.0,23.0,30.0,25,18,21,26,26,26,30,34,31,28,32,41,27,30,30,-17,-13,11,-2,5,10,14,34,47,44,55,73,49,51,42,40,26,11,32,14,20,30.26134801,25.06963788,41.42857143,29.19708029,41.35893648,59.70149254,58.29596413,78.90743551,101.64424509999999,104.6337818,124.61538459999998,156.3981043,127.8317152,141.66666669999998,126.29757790000001,120.7815275,108.61423219999999,97.37827715,113.4615385,85.27131783,44.71544715,53.64511692,43.17548747,25.71428571,32.11678832,33.97341211,44.7761194,37.36920777,27.31411229,31.39013453,38.86397608,40.0,41.07424961,48.54368932,56.66666667,53.63321799,49.73357016,58.93186004,76.77902622,51.92307692,58.13953488,60.97560976,-23.38376891,-18.10584958,15.71428571,-2.919708029,7.385524372,14.92537313,20.92675635,51.59332322,70.25411061,65.76980568,84.61538462,115.3238547,79.28802589,85.0,72.66435986,71.04795737,47.88213628,20.59925094,61.53846154,27.13178295,40.6504065,310,292,18,223,217,6,87,75,12,332,318,14,237,215,22,95,103,-8,276,262,14,306,267,39,-30,-5,-25,290,278,12,305,265,40,-15,13,-28,317,293,24,262,246,16,55,47,8,354,333,21,270,261,9,84,72,12,330,304,26,289,266,23,41,38,3,381,349,32,296,285,11,85,64,21,380,359,21,308,287,21,72,72,0,262.0,288.0,100.0,428.0,197.0,90.0,357.0,152.0,112.0,206.0,126.0,121.0,174.0,203.0,192.0,209.0,401.0,184.0,323.0,600.0,184.0,509.0,437.0,199.0,703.0,347.0,204.0,544.0,285.0,189.0,380.0,246.0,142.0,308.0,209.0,143.0,250.0,168.0,104.0,215.0,147.0,156.0,156.0,116.0,126.0,131.0,139.0,131.0,83.0,109.0,59.0,81.0,59.0,43.0,28.0,17.0,9.0,8.0,6.0,1.0,2.0,1.0,2.0,137.0,170.0,56.0,201.0,92.0,46.0,179.0,88.0,59.0,112.0,71.0,54.0,90.0,100.0,99.0,97.0,189.0,85.0,157.0,307.0,87.0,245.0,229.0,109.0,352.0,188.0,101.0,277.0,160.0,102.0,201.0,137.0,79.0,174.0,115.0,65.0,124.0,79.0,51.0,109.0,67.0,76.0,80.0,59.0,60.0,57.0,69.0,68.0,42.0,47.0,28.0,35.0,25.0,13.0,11.0,4.0,5.0,3.0,2.0,0.0,0.0,1.0,0.0,125.0,118.0,44.0,227.0,105.0,44.0,178.0,64.0,53.0,94.0,55.0,67.0,84.0,103.0,93.0,112.0,212.0,99.0,166.0,293.0,97.0,264.0,208.0,90.0,351.0,159.0,103.0,267.0,125.0,87.0,179.0,109.0,63.0,134.0,94.0,78.0,126.0,89.0,53.0,106.0,80.0,80.0,76.0,57.0,66.0,74.0,70.0,63.0,41.0,62.0,31.0,46.0,34.0,30.0,17.0,13.0,4.0,5.0,4.0,1.0,2.0,0.0,2.0,12.12364512,14.97766283,19.54452119,277,141,320,287,367,530,250,161,320,350,367,517,637,1047,527,594,704,21.15616218,13.9666118,13.14168378,99.59935897,107.0593963,100.3365744,1662,3022,3606,66.72019269,71.05572537,67.31379503,333.70878460000006,656.6558570000001,1066.523017,31.7087846,19.65585705,19.52301719,174.5033113,93.24960754,67.23973257,712,28.58289843,39.24288737,1669,38.80903491,2079,85.95041322,133.3333333,121.3592233,42.86858974,535,18.69158879,102.9211295,2114,13.62346263,39.37920718,1053,24.88129155,8.224299065,5.581835383,11.8708452,34846.83537,43159041.93,5357.0,5260.0,5163.0,5090.0,5010.0,4943.0,4931.0,4914.0,4781.0,4655.0,4443.0,4253.0,3961.0,3496.0,3120.0,2901.0,2692.0,2520.0,2491.0,2452.0,2455.0,2473.0,2476.0,2446.0,2464.5,2483.0,2539.0,2629.0,2542.0,2755.0,2732.0,2695.0,2562.0,2463.0,2299.0,2236.0,43.15904236,51.80837845,53.26809573,57.06799469,59.36183613,62.4434615,63.30075578,63.83366844,58.89843382,60.91423387,58.82892347,57.531397,57.10274986,56.67410272,57.36920619,57.29969584,56.88263376,56.81312342,57.71675792,58.38869128,62.37395116,67.21650531,72.29076063,81.00272409,91.77682783,98.54250158,102.9448235,107.8568881,110.7763226,113.857948,114.25183999999999,114.52988130000001,116.0822791,117.93588829999999,119.6273068,121.874808,124.12230919999999,0,2,4,0,1,15197.80889,4308.217488,2035.769057,5756.976683,2265.488106,31,188,9.00668e-06,0,0.99,0.94,1.0,1.0
39029,2415,Cantabria,Cantabria,Escalante,-2,204,206,46.495283,52.073747999999995,0.0,37.846573,37.846573,5.744617,6.265406,865.016678,9918.269745,9053.253067,5347.499111,2061.542277,146.509664,3667.874842,3521.365178,1902.9100399999998,779.640058,1088.4902789999999,5065.646163,3977.155885,3093.283527,902.655524,244.29786800000002,3571.7284,3327.430532,2137.1199579999998,711.940111,7.0,6.0,6.0,6.0,2.0,9.0,3,3,11,1,2,5,3,6,3,4,3,2,4,3,3,16.0,5.0,6.0,9.0,9.0,10.0,13,15,10,9,6,6,5,12,10,5,11,6,7,9,15,-9,1,0,-3,-7,-1,-10,-12,1,-8,-4,-1,-2,-6,-7,-1,-8,-4,-3,-6,-12,9.900990099,8.683068017,8.8365243,9.160305344,3.095975232,14.04056162,4.716981132,4.893964111,17.51592357,1.6207455430000002,3.333333333,8.665511265,5.253940455,10.8892922,5.366726297,7.194244604,5.72519084,3.8167938930000003,7.90513834,6.0975609760000005,14.40329218,22.63083451,7.235890014,8.8365243,13.74045802,13.93188854,15.60062402,20.44025157,24.46982055,15.92356688,14.58670989,10.0,10.39861352,8.756567426,21.77858439,17.88908766,8.992805755,20.40816327,11.45038168,13.83399209,18.29268293,30.86419753,-12.72984441,1.447178003,0,-4.580152672,-10.83591331,-1.560062402,-15.72327044,-19.57585644,1.5923566880000002,-12.96596434,-6.666666667,-1.7331022530000002,-3.50262697,-10.8892922,-12.52236136,-1.798561151,-14.84230056,-7.6335877860000005,-5.928853755,-12.19512195,-24.69135802,40,38,2,32,32,0,8,6,2,21,20,1,35,34,1,-14,-14,0,48,43,5,36,36,0,12,7,5,35,35,0,42,42,0,-7,-7,0,53,47,6,38,34,4,15,13,2,56,37,19,29,28,1,27,9,18,44,42,2,31,30,1,13,12,1,50,48,2,36,36,0,14,12,2,43,42,1,53,49,4,-10,-7,-3,22.0,34.0,19.0,30.0,32.0,26.0,24.0,26.0,23.0,35.0,25.0,36.0,24.0,33.0,43.0,36.0,38.0,55.0,28.0,51.0,49.0,40.0,61.0,59.0,51.0,61.0,46.0,71.0,49.0,49.0,67.0,40.0,58.0,61.0,63.0,61.0,54.0,62.0,28.0,59.0,34.0,51.0,55.0,38.0,43.0,37.0,42.0,41.0,28.0,33.0,31.0,20.0,20.0,22.0,13.0,10.0,7.0,7.0,3.0,2.0,0.0,0.0,0.0,15.0,14.0,13.0,15.0,19.0,18.0,12.0,18.0,14.0,20.0,15.0,19.0,14.0,17.0,26.0,17.0,24.0,34.0,15.0,30.0,23.0,21.0,36.0,31.0,30.0,30.0,26.0,43.0,30.0,26.0,33.0,24.0,25.0,34.0,24.0,35.0,33.0,32.0,17.0,25.0,23.0,23.0,26.0,17.0,24.0,20.0,19.0,18.0,12.0,16.0,13.0,6.0,5.0,7.0,4.0,4.0,1.0,1.0,1.0,0.0,0.0,0.0,0.0,7.0,20.0,6.0,15.0,13.0,8.0,12.0,8.0,9.0,15.0,10.0,17.0,10.0,16.0,17.0,19.0,14.0,21.0,13.0,21.0,26.0,19.0,25.0,28.0,21.0,31.0,20.0,28.0,19.0,23.0,34.0,16.0,33.0,27.0,39.0,26.0,21.0,30.0,11.0,34.0,11.0,28.0,29.0,21.0,19.0,17.0,23.0,23.0,16.0,17.0,18.0,14.0,15.0,15.0,9.0,6.0,6.0,6.0,2.0,2.0,0.0,0.0,0.0,9.078771696,12.18543046,9.973753281,111,23,95,41,125,34,86,45,95,51,125,42,92,76,197,180,219,26.30173565,23.8410596,28.74015748,110.39325840000001,111.48459380000001,108.1967213,484,483,467,64.61949266,63.97350993,61.28608924,108.70247930000001,129.2670807,122.89507490000001,40.70247934,37.26708075,46.89507495,289.70588239999995,195.6521739,288.1578947,636,84.91321762,29.40397351,222,24.9343832,190,77.77777778,248.0,154.28571430000002,44.66292135,159,11.94968553,75.35014006,269,12.639405199999999,31.96721311,117,18.8034188,3.7735849060000004,7.434944238,5.982905982999999,21869.82226,18795421.8,762.0,781.0,779.0,771.0,749.0,747.0,758.0,754.0,770.0,766.0,763.0,755.0,763.0,782.0,761.0,800.0,789.0,757.0,749.0,719.0,744.0,754.0,750.0,743.0,745.0,747.0,711.0,737.0,1002.0,996.0,1066.0,993.0,1003.0,832.0,816.0,779.0,18.7954216,41.4462637,43.41482821,44.26609936,53.36405968,52.83201522,56.715939799999994,52.99162856,53.31085523,39.21167695,37.82836135,39.74372142,39.63731252,39.53090363,39.90333476,40.11615254,39.58410808,38.25399692,39.85013031,40.27576588,41.97830816,42.56355707,40.48858367,41.60587704,40.59499256,40.16935699,40.59499256,40.7546059,40.96742368,40.11615254,40.32897033,39.74372142,39.85013031,41.02062813,41.4462637,41.55267259,40.54178811,0,1,0,0,1,6849.554026000001,9487.932056,5050.6440170000005,2147.598095,1487.998076,9,51,0.003480959,0,0.64,0.0,1.0,1.0
39030,2416,Cantabria,Cantabria,Guriezo,-2,762,764,290.403744,167.98281799999998,0.122584,40.640343,40.517758,13.968154,6.67455,5936.572489,14217.33477,8280.762286,9447.538587000001,1678.427972,8.591225,10296.07131,10287.48008,5238.02043,2294.956455,26.897653000000002,10220.76341,10193.865759999999,5440.082449,2223.345761,3945.304027,11533.41597,7588.111937999999,7849.577133,1566.902515,6.0,10.0,11.0,15.0,22.0,22.0,23,22,28,25,25,24,22,24,19,27,17,12,14,12,9,24.0,24.0,25.0,20.0,22.0,23.0,19,31,22,16,20,28,19,19,21,27,17,21,17,28,24,-18,-14,-14,-5,0,-1,4,-9,6,9,5,-4,3,5,-2,0,0,-9,-3,-16,-15,6.22406639,10.57082452,11.35190918,15.33742331,23.15789474,23.52941176,23.83419689,23.5042735,31.39013453,27.685492800000002,28.05836139,27.30375427,26.25298329,28.57142857,21.86421174,32.45192308,21.60101652,15.24777637,18.37270341,16.06425703,8.108108108,24.89626556,25.36997886,25.7997936,20.44989775,23.15789474,24.59893048,19.68911917,33.11965812,24.66367713,17.71871539,22.44668911,31.85437998,22.67303103,22.61904762,24.16570771,32.45192308,21.32998745,26.68360864,22.30971129,37.4832664,32.43243243,-18.67219917,-14.79915433,-14.44788442,-5.112474438,0,-1.069518717,4.14507772,-9.615384615,6.726457399,9.966777409,5.6116722779999995,-4.550625711,3.579952267,5.952380952,-2.3014959719999997,0.0,0.0,-11.43583227,-3.937007874,-21.41900937,-20.27027027,118,115,3,116,114,2,2,1,1,102,99,3,136,134,2,-34,-35,1,134,130,4,144,134,10,-10,-4,-6,130,125,5,125,122,3,5,3,2,118,109,9,119,107,12,-1,2,-3,107,97,10,128,110,18,-21,-13,-8,109,100,9,97,93,4,12,7,5,140,134,6,139,134,5,1,0,1,215,205,10,119,117,2,96,88,8,66.0,135.0,52.0,118.0,97.0,48.0,143.0,74.0,58.0,99.0,82.0,94.0,72.0,98.0,105.0,92.0,142.0,140.0,120.0,243.0,146.0,164.0,236.0,140.0,231.0,208.0,151.0,253.0,171.0,136.0,200.0,161.0,118.0,169.0,165.0,111.0,166.0,125.0,115.0,151.0,112.0,112.0,126.0,108.0,100.0,98.0,90.0,90.0,74.0,75.0,56.0,44.0,38.0,39.0,20.0,19.0,11.0,4.0,4.0,3.0,0.0,0.0,2.0,36.0,67.0,17.0,72.0,48.0,27.0,72.0,42.0,39.0,52.0,54.0,45.0,37.0,56.0,57.0,50.0,69.0,81.0,65.0,136.0,77.0,87.0,121.0,74.0,121.0,118.0,73.0,133.0,80.0,77.0,110.0,84.0,68.0,86.0,89.0,58.0,81.0,66.0,65.0,76.0,65.0,58.0,68.0,54.0,46.0,45.0,41.0,43.0,39.0,36.0,21.0,19.0,15.0,9.0,7.0,3.0,4.0,1.0,0.0,0.0,0.0,0.0,1.0,30.0,68.0,35.0,46.0,49.0,21.0,71.0,32.0,19.0,47.0,28.0,49.0,35.0,42.0,48.0,42.0,73.0,59.0,55.0,107.0,69.0,77.0,115.0,66.0,110.0,90.0,78.0,120.0,91.0,59.0,90.0,77.0,50.0,83.0,76.0,53.0,85.0,59.0,50.0,75.0,47.0,54.0,58.0,54.0,54.0,53.0,49.0,47.0,35.0,39.0,35.0,25.0,23.0,30.0,13.0,16.0,7.0,3.0,4.0,3.0,0.0,0.0,1.0,8.648056924,12.84095678,13.56846473,231,75,232,149,262,147,182,83,232,157,262,180,306,327,413,446,517,22.60536398,18.71590432,21.45228216,105.9751973,109.2186128,109.019948,1256,1631,1566,68.74657909,68.44313890000001,64.97925311,190.8821656,333.345187,360.0140485,32.88216561,27.345187,33.01404853,261.3924051,145.751634,158.1039755,290,15.87301587,36.00503567,858,31.86721992,768,122.3404255,152.4390244,167.6767677,45.88500564,407,12.77641278,88.58647937,1009,13.37958375,35.73287077,412,16.01941748,8.5995086,6.739345887000001,7.281553398,43117.98989,79493490.81,2410.0,2330.0,2354.0,2347.0,2358.0,2359.0,2354.0,2383.0,2424.0,2419.0,2435.0,2383.0,2303.0,2244.0,2145.0,2101.0,1979.0,1953.0,1827.0,1784.0,1765.0,1730.0,1717.0,1707.0,1706.0,1705.0,1715.0,1945.0,1716.0,1989.0,2162.0,2378.0,2329.0,2426.0,2380.0,2329.0,79.49349213,29.29799582,29.93955777,30.51822149,29.29799582,29.91439848,27.19719492,25.02091614,21.58667275,24.46741171,21.574093100000002,21.44829664,21.46087629,21.47345593,21.59925239,21.76278779,22.20307541,22.44208868,22.98301347,24.56804888,24.89511968,26.4298365,26.98334093,28.228725899999997,28.97092502,29.97729671,30.63143831,30.43016397,30.493062199999997,29.97729671,29.61248697,29.6753852,29.66280556,29.52442945,29.61248697,29.31057547,30.31694716,0,0,0,0,1,14074.073409999999,6804.424322,8204.901584000001,7869.782703,3294.275596,9,46,0.019049541,0,0.99,0.0,1.0,1.0
39031,2417,Cantabria,Cantabria,Hazas de Cesto,27,383,356,139.20193500000002,77.910838,0.122584,29.621756,29.499171,9.140068,5.568492,8308.388496,14681.82148,6373.432986,11527.41898,1516.302377,34.91832,4056.069058,4021.150737,1372.151334,869.1393220000001,41.803365,3776.8771030000003,3735.073738,1775.215279,786.7992320000001,17.135838,4542.593825,4525.457986,2122.402484,1020.306692,7.0,11.0,7.0,13.0,6.0,7.0,8,16,14,22,9,19,20,16,16,14,14,13,13,6,17,19.0,15.0,13.0,20.0,10.0,12.0,11,20,16,18,11,9,12,13,21,17,24,17,13,14,14,-12,-4,-6,-7,-4,-5,-3,-4,-2,4,-2,10,8,3,-5,-3,-10,-4,0,-8,3,28.34008097,44.71544715,29.78723404,56.76855895,27.77777778,32.55813953,37.91469194,79.20792079,71.42857143,112.24489799999999,46.875,102.7027027,111.1111111,90.39548023,93.02325581,84.33734940000001,87.5,81.25,82.27848101,40.0,46.35761589,76.92307692,60.97560976,55.31914894,87.33624454,46.2962963,55.81395349,52.13270142,99.00990099,81.63265306,91.83673469,57.29166667,48.64864865,66.66666667,73.44632768,122.0930233,102.4096386,146.3414634,106.25,82.27848101,93.33333333,92.71523179,-48.58299595,-16.2601626,-25.53191489,-30.56768559,-18.51851852,-23.25581395,-14.21800948,-19.8019802,-10.20408163,20.40816327,-10.41666667,54.05405405,44.44444444,16.94915254,-29.06976744,-18.07228916,-60.97560976,-25.0,0.0,-53.33333333,19.86754967,89,87,2,101,93,8,-12,-6,-6,73,71,2,78,75,3,-5,-4,-1,96,92,4,99,93,6,-3,-1,-2,92,84,8,97,78,19,-5,6,-11,110,109,1,76,74,2,34,35,-1,77,72,5,77,73,4,0,-1,1,117,88,29,88,87,1,29,1,28,118,96,22,105,86,19,13,10,3,172,157,15,107,104,3,65,53,12,70.0,71.0,48.0,76.0,61.0,43.0,78.0,48.0,69.0,75.0,64.0,75.0,70.0,90.0,89.0,78.0,124.0,95.0,106.0,125.0,95.0,117.0,128.0,113.0,170.0,124.0,81.0,135.0,103.0,95.0,146.0,110.0,81.0,125.0,87.0,60.0,105.0,77.0,60.0,95.0,66.0,71.0,67.0,52.0,75.0,57.0,72.0,58.0,32.0,51.0,39.0,29.0,19.0,15.0,10.0,8.0,6.0,3.0,4.0,0.0,0.0,0.0,0.0,30.0,41.0,22.0,40.0,27.0,20.0,37.0,21.0,31.0,34.0,33.0,42.0,29.0,40.0,49.0,34.0,62.0,41.0,51.0,72.0,51.0,59.0,67.0,54.0,89.0,67.0,46.0,72.0,52.0,51.0,82.0,62.0,44.0,64.0,47.0,33.0,52.0,41.0,30.0,50.0,28.0,34.0,33.0,29.0,38.0,25.0,32.0,28.0,8.0,25.0,15.0,10.0,8.0,5.0,3.0,1.0,1.0,0.0,0.0,0.0,0.0,0.0,0.0,40.0,30.0,26.0,36.0,34.0,23.0,41.0,27.0,38.0,41.0,31.0,33.0,41.0,50.0,40.0,44.0,62.0,54.0,55.0,53.0,44.0,58.0,61.0,59.0,81.0,57.0,35.0,63.0,51.0,44.0,64.0,48.0,37.0,61.0,40.0,27.0,53.0,36.0,30.0,45.0,38.0,37.0,34.0,23.0,37.0,32.0,40.0,30.0,24.0,26.0,24.0,19.0,11.0,10.0,7.0,7.0,5.0,3.0,4.0,0.0,0.0,0.0,0.0,12.61829653,12.12938005,13.62530414,143,87,149,91,164,117,121,73,149,89,164,107,180,224,264,272,293,20.82018927,18.32884097,17.82238443,100.3159558,103.5665295,95.24940618,844,1032,1127,66.5615142,69.54177898,68.55231144,191.2796209,206.35658909999998,249.99822540000002,31.27962085,26.35658915,25.99822538,165.0,151.11111110000002,130.8035714,532,41.95583596,32.34501348,480,32.11678832,528,80.0,120.3125,140.0,44.70774092,283,16.96113074,89.84910837,655,10.83969466,35.1543943,296,23.64864865,9.187279152,4.580152672,13.51351351,23475.94576,21899058.21,1644.0,1580.0,1569.0,1541.0,1550.0,1522.0,1520.0,1524.0,1538.0,1526.0,1516.0,1484.0,1420.0,1347.0,1281.0,1254.0,1285.0,1275.0,1268.0,1247.0,1248.0,1260.0,1261.0,1280.0,1277.0,1274.0,1269.0,1413.0,1593.0,1712.0,1771.0,1682.0,1664.0,1483.0,1293.0,1258.0,21.89905739,57.44539492,59.04363722,67.71980975,75.98500568,76.80695886,80.87106073,78.17688084,72.742857,64.52332513,57.94769964,58.17601997,58.31301217,58.45000437,57.58238712,57.53672305,56.98875426,56.94309019,57.90203558,58.22168404,58.6783247,57.26273865,58.49566843,61.50949678,64.84297360000001,67.76547381,69.22672392,69.68336458,70.23133337,69.59203645,69.40938019,69.50070832,70.77930216,70.36832557,71.64691942,72.14922414,75.07172436,0,0,0,0,2,11700.60925,4411.125835,6426.669997,5390.501896,1487.468266,12,94,0.012404436999999999,0,0.76,0.12,1.0,1.0
39032,2418,Cantabria,Cantabria,Hermandad de Campoo de Suso,712,2155,1443,1268.334007,309.80031099999997,0.0,41.981730999999996,41.981730999999996,13.731416000000001,7.894937,1696.936902,21935.42436,20238.48746,10713.17509,4401.927564,1083.306994,21306.05629,20222.7493,10195.42111,4494.995218999999,1035.277836,21467.15744,20431.87961,9776.317072,4588.783021,1780.3394170000001,21514.24895,19733.90954,10386.06249,4361.179622,10.0,11.0,9.0,6.0,6.0,9.0,9,7,6,5,6,6,8,7,9,11,6,10,9,12,10,21.0,26.0,10.0,22.0,17.0,15.0,18,22,19,19,19,9,17,21,14,19,25,17,22,16,24,-11,-15,-1,-16,-11,-6,-9,-15,-13,-14,-13,-3,-9,-14,-5,-8,-19,-7,-13,-4,-14,1.072386059,1.192541197,0.991298601,0.654593061,0.638569604,0.950771181,0.931002379,0.7188334359999999,0.609137056,0.509061291,0.6155108739999999,0.621826096,0.8309961570000001,0.7430209109999999,0.9672219240000001,1.193835468,0.668598172,1.114330287,1.0240072820000001,1.377252381,1.15406809,2.252010724,2.818733738,1.10144289,2.400174558,1.809280545,1.584618635,1.862004758,2.259190799,1.92893401,1.9344329059999998,1.949117768,0.932739144,1.765866833,2.229062732,1.504567437,2.062079444,2.7427317610000004,1.894361489,2.503128911,1.8363365090000001,2.7697634160000004,-1.179624665,-1.626192541,-0.110144289,-1.745581497,-1.170710941,-0.633847454,-0.931002379,-1.540357363,-1.319796954,-1.425371615,-1.333606894,-0.310913048,-0.934870676,-1.486041821,-0.537345513,-0.868243977,-2.0844761380000003,-0.7800312009999999,-1.479121629,-0.459084127,-1.615695326,36,34,2,40,40,0,-4,-6,2,27,26,1,59,56,3,-32,-30,-2,52,51,1,48,47,1,4,4,0,40,35,5,68,66,2,-28,-31,3,43,43,0,49,48,1,-6,-5,-1,73,71,2,54,52,2,19,19,0,50,47,3,64,62,2,-14,-15,1,34,33,1,51,50,1,-17,-17,0,68,66,2,38,37,1,30,29,1,59.0,35.0,67.0,43.0,56.0,42.0,35.0,53.0,74.0,56.0,64.0,102.0,52.0,97.0,121.0,50.0,116.0,132.0,90.0,115.0,126.0,116.0,126.0,153.0,113.0,145.0,167.0,111.0,152.0,142.0,141.0,180.0,108.0,146.0,105.0,113.0,173.0,117.0,83.0,108.0,91.0,114.0,84.0,89.0,131.0,64.0,106.0,108.0,63.0,80.0,74.0,55.0,51.0,39.0,33.0,23.0,21.0,11.0,7.0,6.0,1.0,1.0,0.0,27.0,15.0,38.0,20.0,28.0,24.0,18.0,30.0,48.0,29.0,42.0,54.0,28.0,57.0,67.0,34.0,65.0,70.0,49.0,60.0,65.0,65.0,75.0,87.0,67.0,81.0,97.0,61.0,83.0,90.0,82.0,119.0,63.0,77.0,63.0,62.0,110.0,64.0,51.0,74.0,50.0,60.0,46.0,49.0,69.0,32.0,46.0,58.0,30.0,39.0,24.0,24.0,19.0,10.0,11.0,5.0,12.0,3.0,1.0,1.0,0.0,0.0,0.0,32.0,20.0,29.0,23.0,28.0,18.0,17.0,23.0,26.0,27.0,22.0,48.0,24.0,40.0,54.0,16.0,51.0,62.0,41.0,55.0,61.0,51.0,51.0,66.0,46.0,64.0,70.0,50.0,69.0,52.0,59.0,61.0,45.0,69.0,42.0,51.0,63.0,53.0,32.0,34.0,41.0,54.0,38.0,40.0,62.0,32.0,60.0,50.0,33.0,41.0,50.0,31.0,32.0,29.0,22.0,18.0,9.0,8.0,6.0,5.0,1.0,1.0,0.0,9.516380655,7.960199005,8.541147132,259,73,239,71,199,72,234,110,239,73,199,65,144,137,493,448,419,25.63702548,24.76506357,26.12219451,120.27491409999999,121.1491443,123.7099024,1247,1217,1048,64.84659386,67.27473742,65.33665835,222.5348837,180.81183240000001,176.98091599999998,39.53488372,36.81183237,39.98091603,269.39890710000003,311.1111111,305.83941610000005,431,22.41289652,29.74018795,538,26.80798005,430,81.37254902,182.8125,308.92857139999995,50.40091638,440,15.22727273,81.05134474,663,5.279034691000001,37.93584379,272,21.69117647,6.590909091,3.016591252,11.76470588,75905.03749,222972132.7,1604.0,1588.0,1603.0,1627.0,1612.0,1643.0,1679.0,1687.0,1744.0,1756.0,1784.0,1809.0,1855.0,1931.0,1949.0,1946.0,1944.0,1921.0,1923.0,1918.0,1893.0,1895.0,1863.0,1856.0,1859.5,1863.0,1836.0,2038.0,2477.0,3296.0,3854.0,3807.0,3696.0,3663.0,3651.0,3729.0,222.9721375,16.72406267,16.37424318,16.42806156,16.57606211,17.07388216,17.28467083,14.782116,11.10901132,9.140155462000001,8.234212673,8.355304036,8.339607008,8.323909979,8.355304036,8.498819725,8.489849995,8.601971627000001,8.624395954,8.615426223,8.718578125,8.727547855,8.741002451,8.660274876,8.319425114,8.11312131,8.000999678,7.87542345,7.821605067,7.565967745,7.530088823,7.3686336720000005,7.229602848,7.296875827999999,7.189239061,7.121966081,7.1937239260000005,0,0,2,0,1,40429.17321,13066.5483,6331.762426,9664.787384000001,5266.111092,26,253,34.48129749,0,0.98,0.0,1.0,1.0
39034,2419,Cantabria,Cantabria,Lamas√≥n,165,1922,1757,756.391208,325.832573,0.17336,51.021931,50.84857,18.739944,8.552825,32999.57255,41399.38031,8399.807769,37051.30469,1874.809909,4029.045243,11053.160909999999,7024.115662,7802.873214,1654.9163720000001,9788.349815000001,23345.730919999998,13557.38111,15841.80416,3258.32211,9796.53796,21983.87789,12187.33993,15477.971019999999,3033.062277,1.0,1.0,0.0,0.0,0.0,1.0,2,0,0,1,1,2,0,1,1,2,3,0,0,0,3,12.0,4.0,6.0,11.0,4.0,5.0,8,1,1,8,6,3,4,5,6,5,3,8,9,6,9,-11,-3,-6,-11,-4,-4,-6,-1,-1,-7,-5,-1,-4,-4,-5,-3,0,-8,-9,-6,-6,3.021148036,2.906976744,0,0,0,3.067484663,6.349206349,0.0,0.0,3.289473684,3.3003300330000003,6.688963211,0.0,3.311258278,3.246753247,6.578947368,10.48951049,0.0,0.0,0.0,3.95256917,36.25377644,11.62790698,18.07228916,33.43465046,12.30769231,15.33742331,25.396825399999997,3.225806452,3.1847133760000004,26.31578947,19.8019802,10.03344482,12.98701299,16.55629139,19.48051948,16.44736842,10.20408163,27.97202797,32.49097473,23.25581395,35.57312253,-33.2326284,-8.720930233,-18.07228916,-33.43465046,-12.30769231,-12.26993865,-19.04761905,-3.225806452,-3.1847133760000004,-23.02631579,-16.50165017,-3.344481605,-12.98701299,-13.24503311,-16.23376623,-9.868421052999999,0.0,-27.97202797,-32.49097473,-23.25581395,-23.71541502,4,4,0,8,8,0,-4,-4,0,10,10,0,6,5,1,4,5,-1,13,12,1,3,2,1,10,10,0,14,14,0,14,14,0,0,0,0,8,7,1,7,7,0,1,0,1,5,5,0,9,9,0,-4,-4,0,7,5,2,15,15,0,-8,-10,2,8,8,0,7,5,2,1,3,-2,7,6,1,4,4,0,3,2,1,6.0,4.0,5.0,4.0,2.0,3.0,3.0,6.0,9.0,2.0,7.0,16.0,7.0,16.0,15.0,11.0,8.0,14.0,8.0,9.0,15.0,18.0,13.0,18.0,14.0,19.0,28.0,16.0,23.0,23.0,23.0,29.0,29.0,21.0,23.0,23.0,28.0,27.0,19.0,19.0,12.0,31.0,25.0,23.0,35.0,14.0,31.0,31.0,18.0,33.0,23.0,18.0,17.0,17.0,10.0,6.0,6.0,2.0,2.0,0.0,1.0,0.0,0.0,5.0,3.0,2.0,2.0,1.0,0.0,2.0,2.0,7.0,2.0,4.0,11.0,3.0,11.0,8.0,6.0,6.0,10.0,6.0,7.0,8.0,14.0,9.0,12.0,11.0,12.0,19.0,9.0,13.0,15.0,13.0,22.0,23.0,15.0,20.0,13.0,19.0,16.0,13.0,16.0,8.0,15.0,15.0,13.0,22.0,8.0,18.0,20.0,11.0,20.0,7.0,8.0,9.0,5.0,4.0,3.0,2.0,0.0,0.0,0.0,1.0,0.0,0.0,1.0,1.0,3.0,2.0,1.0,3.0,1.0,4.0,2.0,0.0,3.0,5.0,4.0,5.0,7.0,5.0,2.0,4.0,2.0,2.0,7.0,4.0,4.0,6.0,3.0,7.0,9.0,7.0,10.0,8.0,10.0,7.0,6.0,6.0,3.0,10.0,9.0,11.0,6.0,3.0,4.0,16.0,10.0,10.0,13.0,6.0,13.0,11.0,7.0,13.0,16.0,10.0,8.0,12.0,6.0,3.0,4.0,2.0,2.0,0.0,0.0,0.0,0.0,4.722222222,3.870967742,4.850746269,72,8,53,6,44,4,71,9,53,6,44,9,12,13,143,124,107,39.72222222,40.0,39.92537313,143.24324319999997,174.3362832,173.4693878,200,174,148,55.55555556,56.12903226,55.2238806,88.5,83.26436782,85.2972973,71.5,71.26436782,72.2972973,841.1764706,1033.333333,823.0769231,469,130.2777778,20.64516129,64,20.89552239,56,118.75,385.7142857,1400.0,45.94594595,68,7.352941176,63.71681416,72,5.555555556,42.85714286,42,14.28571429,4.4117647060000005,1.388888889,2.3809523809999997,38394.25315,70504338.8,268.0,269.0,272.0,287.0,302.0,298.0,302.0,294.0,294.0,303.0,310.0,310.0,318.0,319.0,322.0,326.0,338.0,363.0,360.0,371.0,379.0,393.0,402.0,410.0,413.5,417.0,406.0,516.0,659.0,865.0,964.0,952.0,909.0,1004.0,960.0,894.0,70.50434113,12.68007027,13.61618284,14.24025789,12.89282313,13.50271465,13.67291694,12.26874808,9.346942181000001,7.318698277999999,5.758510661,5.914529422,5.864887089,5.815244756,5.701776566,5.5741248510000005,5.375555518,5.262087328,5.106068566,5.148619138,4.794031043,4.623828757,4.567094662,4.524544091,4.510360567,4.396892376,4.396892376,4.29760771,4.1699559960000006,4.1699559960000006,4.283424186,4.226690091,4.283424186,4.070671329,3.8579184719999997,3.815367901,3.801184377,0,0,0,0,1,37102.81996,8382.337099,11273.11631,6985.600288,3849.2770299999997,1,7,0.000771674,0,0.0,0.0,1.0,0.99
39035,2420,Cantabria,Cantabria,Laredo,0,275,275,57.969616,69.004313,0.0,34.833878000000006,34.833878000000006,5.888033,6.515023,39.106184999999996,3587.80968,3548.703496,1837.223309,761.162827,23.413733999999998,3910.381306,3886.967572,1337.714058,762.064714,30.873932,4759.272207999999,4728.398276,1835.260835,925.3301970000001,1255.801152,7404.899348999999,6149.098197,4046.212158,1324.05196,90.0,92.0,81.0,96.0,101.0,93.0,95,79,87,92,84,93,85,68,72,76,69,72,55,55,59,127.0,144.0,124.0,128.0,122.0,124.0,108,110,141,129,158,130,130,119,158,168,165,138,175,158,160,-37,-52,-43,-32,-21,-31,-13,-31,-54,-37,-74,-37,-45,-51,-86,-92,-96,-66,-120,-103,-101,172.7447217,179.337232,160.0790514,191.2350598,201.5968064,189.4093686,193.4826884,164.58333330000002,185.106383,201.754386,189.1891892,210.8843537,185.1851852,147.505423,163.63636359999998,176.33410669999998,165.07177030000003,172.24880380000002,136.4764268,134.1463415,225.0,243.7619962,280.7017544,245.0592885,254.9800797,243.5129741,252.5458248,219.9592668,229.16666669999998,300.0,282.89473680000003,355.8558559,294.7845805,283.2244009,258.13449019999996,359.0909091,389.7911833,383.72093019999994,330.14354069999996,434.2431762,385.3658537,400.0,-71.01727447,-101.3645224,-84.98023715,-63.74501992,-41.91616766,-63.13645621,-26.47657841,-64.58333333,-114.89361699999999,-81.14035088,-166.66666669999998,-83.90022676,-98.03921569,-110.62906720000001,-195.4545455,-213.4570766,-223.25581400000002,-157.8947368,-297.7667494,-251.2195122,-252.5,521,478,43,608,520,88,-87,-42,-45,451,404,47,505,442,63,-54,-38,-16,458,404,54,512,459,53,-54,-55,1,473,412,61,568,509,59,-95,-97,2,499,432,67,490,426,64,9,6,3,464,370,94,596,546,50,-132,-176,44,497,386,111,523,469,54,-26,-83,57,549,460,89,433,399,34,116,61,55,576,502,74,487,453,34,89,49,40,310.0,447.0,437.0,374.0,448.0,459.0,439.0,486.0,558.0,466.0,505.0,680.0,470.0,654.0,955.0,433.0,796.0,1107.0,494.0,924.0,974.0,650.0,900.0,965.0,814.0,942.0,978.0,847.0,942.0,998.0,886.0,992.0,899.0,900.0,866.0,779.0,871.0,799.0,596.0,777.0,682.0,693.0,727.0,574.0,619.0,579.0,596.0,488.0,414.0,427.0,362.0,348.0,269.0,187.0,132.0,99.0,88.0,56.0,27.0,20.0,9.0,3.0,5.0,155.0,233.0,219.0,197.0,210.0,242.0,218.0,253.0,278.0,239.0,270.0,356.0,245.0,318.0,470.0,234.0,410.0,552.0,244.0,474.0,511.0,327.0,452.0,478.0,416.0,494.0,472.0,413.0,429.0,502.0,445.0,503.0,432.0,403.0,414.0,376.0,410.0,374.0,301.0,361.0,341.0,333.0,322.0,272.0,273.0,263.0,250.0,198.0,164.0,170.0,126.0,123.0,88.0,62.0,36.0,20.0,19.0,10.0,6.0,4.0,2.0,0.0,2.0,155.0,214.0,218.0,177.0,238.0,217.0,221.0,233.0,280.0,227.0,235.0,324.0,225.0,336.0,485.0,199.0,386.0,555.0,250.0,450.0,463.0,323.0,448.0,487.0,398.0,448.0,506.0,434.0,513.0,496.0,441.0,489.0,467.0,497.0,452.0,403.0,461.0,425.0,295.0,416.0,341.0,360.0,405.0,302.0,346.0,316.0,346.0,290.0,250.0,257.0,236.0,225.0,181.0,125.0,96.0,79.0,69.0,46.0,21.0,16.0,7.0,3.0,3.0,11.31781739,11.15689126,10.21280466,1445,715,1530,685,1761,553,1017,739,1530,696,1761,570,1381,1123,2462,2677,3042,19.16400716,21.627080300000003,27.66460531,93.44978166,93.4969517,90.60495753,8931,8320,6831,69.51817545,67.21602844,62.12259003,1481.566902,1413.175481,1167.532279,27.566901799999997,32.17548077,44.53227931,169.3259972,193.8450398,270.8815672,1059,8.243169612,29.95637421,3708,25.5092761,2805,87.64705882,158.21782180000002,186.90987119999997,42.74958591,2839,15.39274392,73.80021885,4721,9.46833298,29.55451551,1705,18.18181818,7.678760127,4.532937937,9.090909091,24269.6117,15269803.33,10996.0,11023.0,11025.0,11148.0,11347.0,11446.0,11643.0,11800.0,11934.0,12094.0,12206.0,12378.0,12591.0,12648.0,12835.0,13090.0,13115.0,12825.0,12847.0,12563.0,12584.0,12634.0,13155.0,13155.0,13034.0,12913.0,13019.0,12278.0,10260.0,7520.0,6866.0,6206.0,5890.0,5566.0,5212.0,5097.0,15.26980305,333.79605380000004,341.3272577,364.5102679,385.7286163,406.4230548,449.64561619999995,492.47524519999996,671.9143637999999,804.0706198,852.5977683,845.655963,853.5800992000001,861.5042355,861.5042355,827.3846074,824.110171,822.7349077,841.3337068,839.8929548000001,858.8846863,857.2474681,840.5478421,828.3014497,824.5685921,810.6194927,799.3554313,792.0206936000001,781.5424969,772.7670071,762.4852766,749.5839969,743.1006127,730.0683554999999,722.0132418,721.8822643999999,720.1140687000001,1,7,18,1,1,2266.142901,10748.777259999999,1129.460478,1590.443742,1535.822978,140,673,0.037453585,0,0.72,0.0,1.0,1.0
39036,2421,Cantabria,Cantabria,Liendo,2,539,537,174.59026200000002,115.052044,0.0,60.00201,60.00201,13.859539000000002,9.562913,2167.473363,7829.208306999999,5661.734944,5118.080503,1282.7467470000001,17.861781,4103.9937469999995,4086.1319670000003,1732.868707,842.5132390000001,45.132477,3534.9249979999995,3489.7925200000004,1875.463609,708.562615,3158.583776,10134.61882,6976.035039,6508.812489,1740.344921,8.0,3.0,5.0,6.0,7.0,11.0,9,13,17,7,7,21,9,9,5,12,5,3,3,1,5,8.0,14.0,15.0,16.0,14.0,7.0,9,11,9,10,8,11,14,16,9,8,13,11,8,16,11,0,-11,-10,-10,-7,4,0,2,8,-3,-1,10,-5,-7,-4,4,-8,-8,-5,-15,-6,8.429926238,3.151260504,5.313496281,6.430868167,7.551240561,11.49425287,9.240246407,12.70772239,16.55306719,7.0,6.944444444,20.56807052,8.893280632,8.928571429,5.081300813,11.976047900000001,5.47645126,3.2858707560000004,3.440366972,1.138952164,9.580838323,8.429926238,14.70588235,15.94048884,17.14898178,15.10248112,7.314524556,9.240246407,10.75268817,8.76338851,10.0,7.936507937000001,10.77375122,13.83399209,15.87301587,9.146341462999999,7.984031936,13.44364012,12.04819277,9.174311927,18.22323462,13.17365269,0,-11.55462185,-10.62699256,-10.71811361,-7.551240561,4.179728318,0.0,1.955034213,7.789678676,-3.0,-0.992063492,9.794319295,-4.940711461999999,-6.944444444,-4.06504065,3.992015968,-8.273009307,-8.762322015,-5.733944954,-17.08428246,-7.185628743,48,43,5,66,57,9,-18,-14,-4,33,31,2,44,36,8,-11,-5,-6,41,40,1,62,58,4,-21,-18,-3,55,44,11,49,36,13,6,8,-2,46,46,0,52,44,8,-6,2,-8,44,43,1,61,59,2,-17,-16,-1,54,53,1,40,40,0,14,13,1,60,51,9,53,51,2,7,0,7,76,68,8,44,40,4,32,28,4,21.0,78.0,18.0,61.0,53.0,31.0,83.0,47.0,28.0,57.0,31.0,39.0,40.0,40.0,49.0,27.0,65.0,67.0,41.0,89.0,79.0,62.0,114.0,62.0,103.0,112.0,69.0,103.0,104.0,72.0,125.0,98.0,61.0,98.0,89.0,81.0,89.0,88.0,47.0,83.0,66.0,50.0,76.0,49.0,46.0,61.0,46.0,36.0,40.0,35.0,40.0,26.0,25.0,25.0,14.0,16.0,7.0,4.0,1.0,1.0,2.0,0.0,0.0,15.0,45.0,6.0,28.0,32.0,16.0,47.0,20.0,16.0,35.0,18.0,23.0,16.0,19.0,25.0,13.0,31.0,42.0,20.0,50.0,43.0,34.0,51.0,36.0,56.0,60.0,35.0,51.0,60.0,41.0,66.0,54.0,33.0,52.0,44.0,42.0,48.0,48.0,24.0,43.0,33.0,26.0,36.0,27.0,21.0,34.0,17.0,17.0,18.0,17.0,19.0,10.0,8.0,9.0,4.0,6.0,4.0,1.0,0.0,0.0,0.0,0.0,0.0,6.0,33.0,12.0,33.0,21.0,15.0,36.0,27.0,12.0,22.0,13.0,16.0,24.0,21.0,24.0,14.0,34.0,25.0,21.0,39.0,36.0,28.0,63.0,26.0,47.0,52.0,34.0,52.0,44.0,31.0,59.0,44.0,28.0,46.0,45.0,39.0,41.0,40.0,23.0,40.0,33.0,24.0,40.0,22.0,25.0,27.0,29.0,19.0,22.0,18.0,21.0,16.0,17.0,16.0,10.0,10.0,3.0,3.0,1.0,1.0,2.0,0.0,0.0,8.480176211,14.28571429,13.56907895,109,39,130,81,160,75,96,38,130,97,160,90,178,165,205,238,306,22.57709251,19.1011236,25.16447368,111.16279070000002,105.6105611,106.4516129,626,830,745,68.94273128,66.61316212,61.26644737,109.7476038,206.67469880000002,206.0738255,32.74760383,28.6746988,41.0738255,266.2337662,133.7078652,185.4545455,2989,329.185022,33.62760835,419,25.41118421,309,120.5128205,283.8709677,156.14035090000002,47.44186047,204,8.823529412000001,74.42244224,451,17.29490022,29.54159593,174,12.06896552,5.882352941000001,7.3170731710000005,3.448275862,22334.619909999998,26367933.8,1216.0,1196.0,1204.0,1194.0,1216.0,1227.0,1223.0,1250.0,1264.0,1290.0,1256.0,1246.0,1193.0,1177.0,1135.0,1099.0,995.0,935.0,908.0,888.0,891.0,831.0,843.0,828.0,819.5,811.0,787.0,815.0,1019.0,1000.0,1116.0,1124.0,1078.0,1198.0,1209.0,1237.0,26.36793327,46.91304348,45.85114758,45.4339742,40.88299181,42.62753506,42.32413623,37.92485325,38.64542547,30.9087554,29.84685951,30.75705599,31.07941724,31.40177849,31.97065129,31.51555305,33.79104425,33.67726969,34.43576675,35.45973779,37.73522899,41.67941373,43.04470844,44.63755228,45.24434993,47.25436715,47.63361569,48.9230607,47.93701451,47.40606657,46.38209553,46.53379494,46.11662156,45.28227479,45.66152332,45.35812449,46.11662156,0,1,0,0,1,7013.689649,9316.931901,4588.627921,4503.469892,2177.422408,18,129,0.004046001,0,1.0,1.0,1.0,1.0
39037,2422,Cantabria,Cantabria,Li√©rganes,63,818,755,247.572304,149.056307,0.17336,47.651646,47.478285,12.933942,8.032521000000001,3369.924492,12726.571259999999,9356.646762999999,8515.154074,2490.713643,19.128103,6647.035233,6627.90713,2862.6537,1755.020964,24.983586,6820.141299,6795.157713,3129.578542,1683.23515,28.587884999999996,6189.29178,6160.703895000001,2947.102122,1247.077711,16.0,15.0,16.0,16.0,15.0,17.0,18,22,17,22,17,9,17,23,12,13,19,15,13,11,13,31.0,18.0,20.0,22.0,19.0,29.0,29,34,24,23,41,32,27,22,27,35,34,34,24,26,34,-15,-3,-4,-6,-4,-12,-11,-12,-7,-1,-24,-23,-10,1,-15,-22,-15,-19,-11,-15,-21,80.80808081,75.37688442,80,78.04878049,76.14213198,87.17948718,89.55223881,111.1111111,89.47368421,122.90502790000001,104.2944785,58.44155844,107.5949367,153.33333330000002,83.33333333,87.83783784,135.71428569999998,107.1428571,97.01492537,88.0,128.0,156.5656566,90.45226131,100,107.3170732,96.44670051,148.7179487,144.278607,171.7171717,126.31578950000001,128.49162009999998,251.5337423,207.79220780000003,170.8860759,146.66666669999998,187.5,236.4864865,241.1347518,242.8571429,179.1044776,208.0,272.0,-75.75757576,-15.07537688,-20,-29.26829268,-20.30456853,-61.53846154,-54.72636816,-60.60606061,-36.84210526,-5.586592179,-147.2392638,-149.3506494,-63.29113924,6.666666667,-104.16666670000001,-148.6486486,-106.3829787,-135.71428569999998,-82.08955224,-120.0,-168.0,95,87,8,99,92,7,-4,-5,1,83,74,9,138,134,4,-55,-60,5,114,108,6,86,78,8,28,30,-2,108,99,9,108,100,8,0,-1,1,106,89,17,116,100,16,-10,-11,1,111,101,10,77,71,6,34,30,4,106,92,14,90,87,3,16,5,11,141,120,21,99,95,4,42,25,17,120,112,8,92,87,5,28,25,3,69.0,87.0,62.0,85.0,96.0,68.0,88.0,86.0,105.0,96.0,109.0,139.0,90.0,129.0,157.0,108.0,146.0,155.0,106.0,187.0,196.0,156.0,204.0,170.0,196.0,189.0,189.0,193.0,215.0,171.0,215.0,205.0,146.0,204.0,157.0,128.0,209.0,138.0,82.0,160.0,106.0,151.0,144.0,106.0,117.0,92.0,121.0,90.0,73.0,83.0,84.0,76.0,68.0,28.0,34.0,23.0,19.0,8.0,7.0,2.0,1.0,0.0,1.0,30.0,41.0,37.0,47.0,48.0,32.0,39.0,53.0,54.0,43.0,52.0,73.0,50.0,68.0,84.0,55.0,73.0,72.0,54.0,96.0,85.0,78.0,99.0,92.0,101.0,92.0,100.0,99.0,115.0,95.0,106.0,108.0,80.0,97.0,86.0,72.0,107.0,76.0,36.0,91.0,52.0,80.0,66.0,52.0,62.0,40.0,59.0,38.0,32.0,37.0,33.0,35.0,22.0,10.0,10.0,7.0,8.0,4.0,2.0,1.0,0.0,0.0,0.0,39.0,46.0,25.0,38.0,48.0,36.0,49.0,33.0,51.0,53.0,57.0,66.0,40.0,61.0,73.0,53.0,73.0,83.0,52.0,91.0,111.0,78.0,105.0,78.0,95.0,97.0,89.0,94.0,100.0,76.0,109.0,97.0,66.0,107.0,71.0,56.0,102.0,62.0,46.0,69.0,54.0,71.0,78.0,54.0,55.0,52.0,62.0,52.0,41.0,46.0,51.0,41.0,46.0,18.0,24.0,16.0,11.0,4.0,5.0,1.0,1.0,0.0,1.0,10.39823009,10.92607636,10.070744900000001,260,112,283,127,310,126,232,123,283,142,310,116,269,242,492,514,588,21.7699115,20.8773355,24.46941323,102.5089606,101.14379079999999,97.12879409,1533,1679,1573,67.83185841,68.19658814,65.45984186,267.0939335,299.6134604,279.38080099999996,32.09393346,30.61346039,37.38080102,209.3617021,191.0780669,242.9752066,381,16.85840708,32.29082047,795,27.09113608,651,58.99280576,126.60550459999999,217.70833330000002,45.34050179,506,12.25296443,78.75816993,964,9.024896266,31.25512715,381,18.11023622,4.940711461999999,4.771784232,10.23622047,30984.48159,36823032.17,2403.0,2407.0,2379.0,2370.0,2355.0,2372.0,2386.0,2370.0,2435.0,2441.0,2457.0,2462.0,2467.0,2464.0,2447.0,2403.0,2391.0,2328.0,2260.0,2266.0,2266.0,2270.0,2268.0,2258.0,2260.5,2263.0,2267.0,2380.0,2410.0,2676.0,2656.0,2633.0,2985.0,2511.0,2522.0,2378.0,36.82303238,64.57914643,68.48974234,68.19101627,81.06339449,71.50416003,72.1287691,72.67190742,65.44816774,64.63346026,61.56472875,61.45610108,61.38820879,61.320316500000004,61.59188566,61.64619949,61.53757183,61.53757183,61.37463033,63.22130063,64.93218634,65.25806933,66.45297364,66.91464121,66.99611196,66.86032738,66.7245428,66.29003214,66.12709065,64.3618911,64.79640176,64.41620493,63.95453736,64.3618911,64.60630335,65.366697,65.25806933,0,0,0,1,2,14420.792480000002,4481.15917,3275.816129,2919.598129,2048.3256260000003,30,169,0.000129618,0,1.0,1.0,1.0,0.98
39038,2423,Cantabria,Cantabria,Limpias,-1,468,469,166.793694,109.142527,0.0,32.366203000000006,32.366203000000006,11.625742,7.64553,1116.032328,6136.5827899999995,5020.5504630000005,4112.959075,1286.831117,6.044657,2339.725785,2333.681128,1072.483182,599.829176,391.420483,5207.288877,4815.868394,3151.0716199999997,1090.254678,319.856966,4845.29996,4525.442994,2496.321725,1068.803927,10.0,14.0,15.0,14.0,19.0,8.0,20,20,29,18,16,22,14,14,14,9,19,25,15,8,19,17.0,13.0,10.0,11.0,9.0,11.0,9,12,6,9,11,19,18,14,12,17,23,13,16,19,24,-7,1,5,3,10,-3,11,8,23,9,5,3,-4,0,2,-8,-4,12,-1,-11,-5,54.64480874,78.65168539,86.70520231,84.84848485,116.5644172,50.31446541,130.7189542,136.9863014,201.38888889999998,132.3529412,122.13740459999998,171.875,121.7391304,127.2727273,132.0754717,84.90566038,211.11111110000002,277.77777779999997,168.53932580000003,96.38554217,123.45679009999998,92.89617486,73.03370787,57.80346821,66.66666667,55.21472393,69.18238994,58.82352941,82.19178082,41.66666667,66.17647059,83.96946565,148.4375,156.5217391,127.2727273,113.20754720000001,160.37735849999999,232.32323230000003,144.4444444,179.7752809,228.91566269999998,296.2962963,-38.25136612,5.617977528,28.9017341,18.18181818,61.34969325,-18.86792453,71.89542484,54.79452055,159.72222219999998,66.17647059,38.16793893,23.4375,-34.782608700000004,0.0,18.86792453,-75.47169811,-40.4040404,133.3333333,-11.23595506,-132.5301205,-61.72839506,168,164,4,171,156,15,-3,8,-11,122,118,4,155,155,0,-33,-37,4,108,105,3,138,128,10,-30,-23,-7,149,145,4,140,139,1,9,6,3,138,131,7,115,111,4,23,20,3,174,167,7,136,130,6,38,37,1,176,160,16,161,149,12,15,11,4,192,173,19,122,117,5,70,56,14,202,193,9,140,138,2,62,55,7,83.0,117.0,69.0,90.0,100.0,67.0,108.0,75.0,72.0,83.0,57.0,65.0,79.0,67.0,88.0,64.0,113.0,106.0,98.0,193.0,95.0,128.0,167.0,149.0,193.0,163.0,125.0,190.0,152.0,105.0,179.0,139.0,96.0,160.0,107.0,69.0,124.0,77.0,54.0,115.0,61.0,82.0,75.0,61.0,81.0,67.0,78.0,48.0,48.0,40.0,28.0,53.0,25.0,19.0,17.0,8.0,8.0,6.0,2.0,1.0,1.0,0.0,1.0,42.0,64.0,33.0,45.0,48.0,35.0,57.0,33.0,36.0,42.0,24.0,30.0,37.0,38.0,48.0,34.0,57.0,55.0,50.0,96.0,41.0,62.0,75.0,75.0,92.0,89.0,72.0,83.0,86.0,52.0,93.0,81.0,60.0,89.0,58.0,39.0,73.0,46.0,26.0,58.0,32.0,44.0,41.0,27.0,46.0,32.0,35.0,19.0,18.0,19.0,7.0,19.0,10.0,5.0,6.0,0.0,1.0,1.0,0.0,0.0,0.0,0.0,1.0,41.0,53.0,36.0,45.0,52.0,32.0,51.0,42.0,36.0,41.0,33.0,35.0,42.0,29.0,40.0,30.0,56.0,51.0,48.0,97.0,54.0,66.0,92.0,74.0,101.0,74.0,53.0,107.0,66.0,53.0,86.0,58.0,36.0,71.0,49.0,30.0,51.0,31.0,28.0,57.0,29.0,38.0,34.0,34.0,35.0,35.0,43.0,29.0,30.0,21.0,21.0,34.0,15.0,14.0,11.0,8.0,7.0,5.0,2.0,1.0,1.0,0.0,0.0,14.56582633,16.20421754,14.32942376,145,104,152,147,207,137,123,104,152,145,207,144,292,281,268,275,382,18.767507000000002,15.26082131,19.47985722,103.1294452,103.8461538,98.68287741,952,1235,1298,66.66666667,68.53496115,66.19071902,236.1512605,314.2672065,310.4298921,28.1512605,22.26720648,29.42989214,128.8461538,94.17808219,135.9430605,660,46.21848739,37.45837958,675,31.05558389,609,83.07692308,135.08771930000003,149.3975904,45.66145092,321,21.4953271,85.97285068,760,15.39473684,32.11752786,317,26.182965300000003,11.21495327,6.973684211,12.93375394,20198.00725,9961072.826,1961.0,1928.0,1879.0,1867.0,1824.0,1813.0,1815.0,1837.0,1875.0,1897.0,1841.0,1802.0,1741.0,1648.0,1536.0,1479.0,1497.0,1457.0,1428.0,1389.0,1330.0,1344.0,1311.0,1261.0,1266.0,1271.0,1170.0,1166.0,1264.0,1502.0,2005.0,1840.0,1644.0,1464.0,1484.0,1474.0,9.961072922,147.9760274,148.97993540000002,146.97211950000002,165.0424621,184.7190573,201.283538,150.7869696,126.8939611,117.0556635,117.45722669999999,127.5966967,127.09474270000001,126.59278870000001,131.6123283,134.9252245,133.51975339999998,139.4428101,143.358051,146.269384,150.2850157,148.4779814,154.2002565,165.4440253,174.7803689,180.9042072,184.8194481,190.4413325,188.23273500000002,184.41788490000002,182.2092875,182.00850590000002,183.11280459999998,187.4296087,188.6342982,193.553447,196.8663432,0,1,0,0,1,4998.505919,4072.019135,3431.111334,2445.920287,1728.6513899999998,26,132,1.22721e-05,0,1.0,1.0,1.0,1.0
39039,2424,Cantabria,Cantabria,Luena,202,1320,1118,710.966219,234.759387,0.0,41.178886,41.178886,15.779546,6.8226770000000005,16906.827230000003,26186.04324,9279.216004,22397.683259999998,1882.4991,6.8910860000000005,5393.979566,5387.088479999999,2136.861111,1067.960024,8190.140284,20240.85197,12050.71168,13588.500380000001,2694.043403,4011.491833,15058.804240000001,11047.312409999999,9712.477238,2108.905534,3.0,3.0,5.0,2.0,1.0,1.0,0,1,0,7,2,4,2,4,1,2,2,4,2,2,1,6.0,19.0,14.0,8.0,17.0,13.0,12,19,22,23,11,11,9,11,12,17,10,11,8,10,11,-3,-16,-9,-6,-16,-12,-12,-18,-22,-16,-9,-7,-7,-7,-11,-15,-8,-7,-6,-8,-10,5.736137667,5.952380952,9.98003992,4.12371134,2.127659574,2.178649237,0.0,2.304147465,0.0,16.70644391,4.8426150119999996,9.852216749,5.076142132,10.23017903,2.5445292619999997,5.194805195,5.555555556,11.11111111,5.780346821,6.0975609760000005,9.345794393,11.47227533,37.6984127,27.94411178,16.49484536,36.17021277,28.32244009,26.31578947,43.77880184,51.64319249,54.89260143,26.63438257,27.09359606,22.84263959,28.13299233,30.53435115,44.15584416,26.954177899999998,30.55555556,23.12138728,30.48780488,34.26791277,-5.736137667,-31.74603175,-17.96407186,-12.37113402,-34.04255319,-26.14379085,-26.31578947,-41.47465438,-51.64319249,-38.18615752,-21.79176755,-17.24137931,-17.76649746,-17.902813300000002,-27.98982188,-38.96103896,-21.56334232,-19.44444444,-17.34104046,-24.390243899999998,-31.15264798,13,13,0,24,23,1,-11,-10,-1,17,15,2,30,29,1,-13,-14,1,20,17,3,26,26,0,-6,-9,3,14,14,0,17,17,0,-3,-3,0,20,16,4,17,17,0,3,-1,4,17,12,5,22,22,0,-5,-10,5,29,25,4,35,35,0,-6,-10,4,42,37,5,30,30,0,12,7,5,55,55,0,25,23,2,30,32,-2,16.0,11.0,13.0,15.0,9.0,22.0,15.0,16.0,34.0,18.0,27.0,46.0,14.0,29.0,63.0,26.0,46.0,40.0,24.0,43.0,49.0,32.0,34.0,48.0,49.0,40.0,43.0,47.0,53.0,57.0,48.0,48.0,66.0,55.0,60.0,60.0,55.0,70.0,55.0,51.0,54.0,57.0,56.0,47.0,60.0,30.0,48.0,63.0,30.0,36.0,45.0,24.0,29.0,22.0,9.0,7.0,11.0,6.0,2.0,1.0,3.0,1.0,2.0,7.0,6.0,8.0,8.0,7.0,12.0,7.0,9.0,13.0,11.0,10.0,24.0,8.0,14.0,25.0,11.0,26.0,19.0,13.0,19.0,29.0,18.0,23.0,30.0,27.0,26.0,25.0,33.0,32.0,35.0,32.0,27.0,37.0,35.0,36.0,39.0,34.0,43.0,36.0,23.0,34.0,31.0,31.0,30.0,29.0,15.0,22.0,31.0,15.0,14.0,20.0,9.0,10.0,4.0,1.0,1.0,1.0,0.0,0.0,0.0,0.0,0.0,1.0,9.0,5.0,5.0,7.0,2.0,10.0,8.0,7.0,21.0,7.0,17.0,22.0,6.0,15.0,38.0,15.0,20.0,21.0,11.0,24.0,20.0,14.0,11.0,18.0,22.0,14.0,18.0,14.0,21.0,22.0,16.0,21.0,29.0,20.0,24.0,21.0,21.0,27.0,19.0,28.0,20.0,26.0,25.0,17.0,31.0,15.0,26.0,32.0,15.0,22.0,25.0,15.0,19.0,18.0,8.0,6.0,10.0,6.0,2.0,1.0,3.0,1.0,1.0,8.05134189,5.070422535,7.383627607999999,144,36,113,14,115,24,117,33,113,22,115,22,36,46,261,224,209,30.45507585,31.54929577,33.54735152,110.0490196,121.18380060000001,118.5964912,527,450,368,61.49358226,63.38028169,59.06902087,118.52561670000001,85.77777778,102.79347829999999,49.5256167,49.77777778,56.79347826,378.26086960000004,622.2222222,454.3478261,426,49.70828471,23.94366197,170,24.39807384,152,119.56521740000001,259.25925930000005,305.55555560000005,37.25490196,152,8.552631579,68.22429907,219,5.02283105,30.87719298,88,18.18181818,3.289473684,2.283105023,10.22727273,49955.11294,90547399.76,623.0,600.0,593.0,601.0,611.0,615.0,634.0,650.0,672.0,694.0,710.0,710.0,722.0,758.0,792.0,820.0,831.0,843.0,857.0,914.0,941.0,956.0,985.0,1010.0,1016.0,1022.0,1164.0,1392.0,1649.0,1995.0,2274.0,2486.0,2319.0,2802.0,2827.0,2764.0,90.54740143,30.52544807,31.22121624,30.94511776,25.6108951,27.45523296,25.11391784,22.03265879,18.21145581,15.37316343,12.85514528,11.28690591,11.22064227,11.15437864,10.87828015,10.55800592,10.39234683,10.09416047,9.464655931,9.310040782,9.177513511,9.056030179,8.746799881,8.371305946,7.973724133999999,7.8411968629999995,7.8411968629999995,7.664493835,7.421527171,7.1785605079999995,7.00185748,6.792022635,6.747846878,6.637407485,6.5490559710000005,6.626363546,6.880374148,0,1,0,0,2,31849.79192,6380.585511,8542.333405,10028.134890000001,3311.517678,3,14,0.016019804,0,0.67,0.0,1.0,1.0
39040,2425,Cantabria,Cantabria,Marina de Cudeyo,-3,87,90,22.197902,17.313057,0.0,16.293179000000002,16.293179000000002,3.4276720000000003,2.624069,387.196401,8809.622743,8422.426341,5055.957227,1977.087534,356.78585899999996,5978.220795,5621.434935,2735.482658,1314.612382,40.789857,5809.851942,5769.0620850000005,2859.476446,1335.5713119999998,23.285237,4826.051927,4802.7666899999995,1992.144835,1085.585202,45.0,39.0,47.0,42.0,36.0,37.0,31,41,50,45,62,43,42,32,44,34,40,29,23,21,34,44.0,49.0,43.0,53.0,42.0,54.0,43,35,45,64,41,44,32,55,46,62,53,43,41,35,58,1,-10,4,-11,-6,-17,-12,6,5,-19,21,-1,10,-23,-2,-28,-13,-14,-18,-14,-24,82.72058824,72.89719626,90.73359073,82.67716535,71.71314741,73.41269841,63.52459016,81.34920635,101.8329939,94.73684211,129.9790356,88.47736626,90.51724138,69.26406926,93.02325581,70.83333333,88.30022075,64.01766004,53.61305361,47.40406321,107.1428571,80.88235294,91.58878505,83.01158301,104.3307087,83.66533865,107.1428571,88.1147541,69.44444444,91.6496945,134.7368421,85.95387841,90.53497942,68.96551724,119.047619,97.25158562,129.1666667,112.05073999999999,94.92273731,95.57109557,79.00677201,138.09523810000002,1.838235294,-18.69158879,7.722007722,-21.65354331,-11.95219124,-33.73015873,-24.59016393,11.9047619,10.18329939,-40.0,44.02515723,-2.057613169,21.55172414,-49.78354978,-4.22832981,-58.33333333,-27.48414376,-30.90507726,-41.95804196,-31.6027088,-57.14285714,222,206,16,197,190,7,25,16,9,188,173,15,233,213,20,-45,-40,-5,222,216,6,232,224,8,-10,-8,-2,203,188,15,195,187,8,8,1,7,210,192,18,202,193,9,8,-1,9,195,179,16,199,187,12,-4,-8,4,241,214,27,210,209,1,31,5,26,219,195,24,233,208,25,-14,-13,-1,307,296,11,181,175,6,126,121,5,141.0,225.0,159.0,205.0,219.0,179.0,237.0,218.0,226.0,233.0,235.0,276.0,241.0,240.0,381.0,226.0,329.0,415.0,238.0,404.0,403.0,290.0,404.0,417.0,403.0,470.0,426.0,395.0,427.0,403.0,450.0,431.0,355.0,428.0,396.0,286.0,455.0,306.0,218.0,376.0,238.0,287.0,290.0,203.0,240.0,217.0,218.0,215.0,141.0,191.0,137.0,135.0,89.0,68.0,68.0,34.0,22.0,15.0,7.0,7.0,2.0,1.0,0.0,76.0,124.0,82.0,112.0,111.0,91.0,122.0,120.0,140.0,118.0,127.0,147.0,121.0,135.0,189.0,123.0,158.0,229.0,125.0,216.0,216.0,139.0,221.0,209.0,210.0,247.0,205.0,198.0,210.0,221.0,235.0,221.0,179.0,216.0,206.0,136.0,226.0,160.0,119.0,190.0,125.0,133.0,143.0,85.0,111.0,108.0,94.0,102.0,53.0,76.0,52.0,45.0,32.0,22.0,22.0,8.0,11.0,6.0,1.0,3.0,0.0,0.0,0.0,65.0,101.0,77.0,93.0,108.0,88.0,115.0,98.0,86.0,115.0,108.0,129.0,120.0,105.0,192.0,103.0,171.0,186.0,113.0,188.0,187.0,151.0,183.0,208.0,193.0,223.0,221.0,197.0,217.0,182.0,215.0,210.0,176.0,212.0,190.0,150.0,229.0,146.0,99.0,186.0,113.0,154.0,147.0,118.0,129.0,109.0,124.0,113.0,88.0,115.0,85.0,90.0,57.0,46.0,46.0,26.0,11.0,9.0,6.0,4.0,2.0,1.0,0.0,11.015625,12.52601703,11.24180486,542,251,560,307,677,273,434,313,560,355,677,310,662,583,976,981,1244,19.0625,18.56196783,23.98765908,102.93301629999999,102.6457055,99.61508853,3580,3642,3359,69.921875,68.91201514,64.77053606,591.2625697999999,688.9357496,620.0348318,27.26256983,26.93574959,37.0348318,173.0496454,148.1873112,213.3790738,543,10.60546875,32.26111637,1705,25.56883918,1326,78.98550725,130.212766,195.27897,47.36424891,1195,13.30543933,79.83128834,2082,10.80691643,32.17859892,836,16.86602871,6.4435146439999995,4.851104707,7.7751196170000005,32846.06758,29271828.85,5186.0,5106.0,5125.0,5118.0,5147.0,5174.0,5203.0,5223.0,5306.0,5278.0,5280.0,5285.0,5252.0,5254.0,5157.0,5065.0,5000.0,5059.0,5120.0,5112.0,4982.0,4765.0,4597.0,4640.0,4571.5,4503.0,4441.0,4563.0,4747.0,4946.0,4589.0,4295.0,3939.0,3383.0,2947.0,2435.0,29.27182961,83.18578076,100.67700040000001,115.57186709999999,134.5662384,146.728102,156.7718883,168.9679144,162.1695693,155.88366230000003,151.7158326,153.83391,156.17404380000002,158.51417769999998,157.0451886,162.784495,170.1977658,174.6388958,174.9121961,172.82828130000001,170.8126915,173.0332565,176.17621,179.4899762,179.42165119999999,180.5490149,180.37820219999998,180.3098771,181.26642819999998,178.4309375,177.7476868,176.75697319999998,175.8345846,174.843871,175.08300880000002,174.4339206,177.1669236,0,1,0,0,1,6777.624784999999,3744.2484770000005,3234.7490239999997,3553.9434189999997,1738.329164,41,232,0.001591511,0,1.0,0.03,1.0,1.0
39041,2426,Cantabria,Cantabria,Mazcuerras,94,884,790,350.40379900000005,194.573358,0.0,41.267117,41.267117,12.375312,7.309943,5819.568754999999,17688.56296,11868.994209999999,12096.682659999999,2582.6404190000003,188.858192,8355.309177,8166.4509849999995,4120.971778,1787.4307789999998,394.418409,8542.567806000001,8148.149397,4264.962507,1911.77839,353.103025,8384.417937999999,8031.314912999999,4149.721921,1814.029507,14.0,11.0,13.0,15.0,18.0,15.0,17,26,17,20,17,10,13,19,15,11,13,8,12,7,9,19.0,19.0,19.0,21.0,16.0,16.0,22,20,22,19,15,19,25,27,20,20,14,23,22,25,29,-5,-8,-6,-6,2,-1,-5,6,-5,1,2,-9,-12,-8,-5,-9,-1,-15,-10,-18,-20,20,15.98837209,19.46107784,23.11248074,28.16901408,24,27.77777778,42.83360791,28.71621622,34.30531732,30.19538188,18.18181818,24.43609023,40.77253219,32.96703297,24.94331066,32.17821782,19.8019802,31.33159269,15.59020045,31.25,27.14285714,27.61627907,28.44311377,32.35747304,25.03912363,25.6,35.94771242,32.94892916,37.16216216,32.59005146,26.64298401,34.54545455,46.9924812,57.93991416,43.95604396,45.35147392,33.57314149,56.93069307,57.44125326,55.67928731,64.73214286,-7.142857143,-11.62790698,-8.982035928,-9.244992296,3.129890454,-1.6,-8.169934641000001,9.884678747999999,-8.445945946,1.715265866,3.5523978689999995,-16.36363636,-22.55639098,-17.16738197,-10.98901099,-20.40816327,-2.398081535,-37.12871287,-26.10966057,-40.08908686,-44.64285714,55,55,0,63,63,0,-8,-8,0,80,80,0,45,45,0,35,35,0,51,46,5,54,49,5,-3,-3,0,60,59,1,56,55,1,4,4,0,61,59,2,56,54,2,5,5,0,82,77,5,73,72,1,9,5,4,84,76,8,87,84,3,-3,-8,5,88,77,11,77,77,0,11,0,11,89,86,3,76,76,0,13,10,3,55.0,101.0,62.0,85.0,98.0,78.0,108.0,71.0,80.0,101.0,100.0,98.0,76.0,95.0,141.0,101.0,129.0,156.0,98.0,153.0,128.0,126.0,170.0,171.0,154.0,197.0,152.0,185.0,189.0,131.0,192.0,140.0,131.0,184.0,156.0,94.0,150.0,117.0,76.0,151.0,99.0,98.0,99.0,88.0,130.0,83.0,86.0,97.0,58.0,81.0,45.0,43.0,32.0,26.0,26.0,12.0,11.0,5.0,4.0,1.0,0.0,0.0,0.0,28.0,48.0,26.0,47.0,45.0,34.0,58.0,35.0,49.0,43.0,50.0,50.0,36.0,53.0,71.0,49.0,75.0,90.0,56.0,74.0,72.0,80.0,82.0,93.0,69.0,105.0,93.0,90.0,110.0,79.0,104.0,79.0,71.0,104.0,85.0,44.0,85.0,65.0,37.0,79.0,47.0,53.0,52.0,45.0,63.0,35.0,41.0,42.0,24.0,35.0,15.0,17.0,15.0,6.0,12.0,3.0,5.0,2.0,1.0,1.0,0.0,0.0,0.0,27.0,53.0,36.0,38.0,53.0,44.0,50.0,36.0,31.0,58.0,50.0,48.0,40.0,42.0,70.0,52.0,54.0,66.0,42.0,79.0,56.0,46.0,88.0,78.0,85.0,92.0,59.0,95.0,79.0,52.0,88.0,61.0,60.0,80.0,71.0,50.0,65.0,52.0,39.0,72.0,52.0,45.0,47.0,43.0,67.0,48.0,45.0,55.0,34.0,46.0,30.0,26.0,17.0,20.0,14.0,9.0,6.0,3.0,3.0,0.0,0.0,0.0,0.0,11.54249738,12.74787535,11.92307692,223,111,215,142,244,115,185,109,215,128,244,133,270,248,408,402,465,21.40608604,18.98016997,22.35576923,108.9912281,106.6341463,105.94059409999998,1278,1446,1367,67.05141658,68.27195467,65.72115385,251.9248826,297.80082989999994,282.01609360000003,31.92488263,27.80082988,34.01609364,185.4545455,148.88888889999998,187.5,1377,72.24554040000001,33.47497639,709,27.06730769,563,77.55102041,117.0,148.5148515,51.4254386,469,13.219616199999999,82.34146341,844,11.96682464,32.97029703,333,16.51651652,7.6759061829999995,6.279620853,8.108108108,34413.118330000005,55980582.83,2080.0,2093.0,2105.0,2120.0,2125.0,2119.0,2127.0,2131.0,2104.0,2127.0,2121.0,2118.0,2087.0,2053.0,2010.0,2018.0,1997.0,1946.0,1906.0,1885.0,1871.0,1869.0,1870.0,1872.0,1886.5,1901.0,1857.0,1919.0,1939.0,1871.0,1796.0,1615.0,1676.0,1625.0,1757.0,1755.0,55.98058319,31.35015571,31.38588239,29.02792196,29.93895212,28.84928859,32.08255251,33.42230276,34.63700965,34.27974291,33.17221605,33.95820286,33.69918448,33.4401661,33.40443942,33.38657609,33.42230276,33.67238947,34.04751954,34.762053,35.67308317,36.04821324,35.90530654,36.67343002,37.28078346,37.8345469,37.88813691,37.99531693,37.58446018,38.06677027,37.99531693,37.85241023,37.95959025,37.87027357,37.60232352,37.38796348,37.15574011,0,0,0,0,1,11515.69828,2247.112313,7516.677188,5271.830602,3777.86706,21,120,0.134305339,0,0.99,0.0,1.0,1.0
39042,2427,Cantabria,Cantabria,Medio Cudeyo,-1,557,558,123.36356599999999,117.70529599999999,0.0,39.141506,39.141506,9.61065,7.885797999999999,999.1307810000001,9422.319418000001,8423.188637000001,5347.945117,2127.162488,6.503814,2959.942155,2953.438341,989.0395619999999,647.47324,14.685169,3795.7504670000003,3781.0652979999995,1732.74701,757.847941,27.200588,3634.426337,3607.225749,1514.073301,770.598524,54.0,56.0,58.0,61.0,74.0,80.0,71,67,67,84,74,69,61,67,66,40,60,43,55,56,47,40.0,49.0,59.0,58.0,45.0,57.0,50,60,62,46,63,51,44,69,55,74,70,73,71,57,66,14,7,-1,3,29,23,21,7,5,38,11,18,17,-2,11,-34,-10,-30,-16,-1,-19,465.5172414,495.5752212,532.1100917,580.952381,718.4466019,740.7407407,682.6923077,690.7216495,705.2631579,913.0434783,795.6989247,718.75,628.8659794,683.6734694,709.6774194,434.7826087,638.2978722999999,457.4468085,617.9775281000001,658.8235294,635.2941176,344.8275862,433.6283186,541.2844037,552.3809524,436.8932039,527.7777778,480.7692308,618.556701,652.6315789,500.0,677.4193548,531.25,453.6082473999999,704.0816327,591.3978495,804.3478261,795.4545455,776.5957447000001,797.752809,670.5882353,776.4705882000001,120.6896552,61.94690265,-9.174311927,28.57142857,281.5533981,212.962963,201.9230769,72.16494845,52.63157895,413.0434783,118.2795699,187.5,175.257732,-20.40816327,118.2795699,-369.56521739999994,-113.6363636,-319.1489362,-179.7752809,-11.76470588,-223.52941180000002,397,363,34,390,357,33,7,6,1,444,414,30,417,370,47,27,44,-17,368,348,20,419,394,25,-51,-46,-5,390,348,42,382,364,18,8,-16,24,395,357,38,434,397,37,-39,-40,1,444,390,54,375,350,25,69,40,29,453,392,61,397,377,20,56,15,41,478,390,88,442,416,26,36,-26,62,434,397,37,380,360,20,54,37,17,269.0,440.0,265.0,356.0,380.0,294.0,421.0,328.0,340.0,433.0,374.0,369.0,341.0,436.0,531.0,341.0,574.0,529.0,395.0,693.0,527.0,492.0,679.0,557.0,694.0,601.0,551.0,678.0,605.0,485.0,587.0,574.0,363.0,572.0,405.0,363.0,546.0,378.0,239.0,426.0,281.0,284.0,349.0,241.0,288.0,247.0,245.0,234.0,192.0,178.0,145.0,182.0,133.0,74.0,60.0,39.0,32.0,22.0,9.0,9.0,3.0,4.0,2.0,139.0,234.0,117.0,192.0,178.0,160.0,219.0,168.0,181.0,208.0,198.0,181.0,174.0,220.0,267.0,176.0,280.0,267.0,199.0,342.0,255.0,220.0,342.0,297.0,351.0,302.0,280.0,329.0,313.0,242.0,298.0,290.0,173.0,283.0,200.0,174.0,262.0,176.0,122.0,195.0,137.0,130.0,158.0,110.0,141.0,105.0,103.0,90.0,79.0,73.0,61.0,63.0,43.0,23.0,20.0,8.0,7.0,4.0,0.0,1.0,1.0,0.0,1.0,130.0,206.0,148.0,164.0,202.0,134.0,202.0,160.0,159.0,225.0,176.0,188.0,167.0,216.0,264.0,165.0,294.0,262.0,196.0,351.0,272.0,272.0,337.0,260.0,343.0,299.0,271.0,349.0,292.0,243.0,289.0,284.0,190.0,289.0,205.0,189.0,284.0,202.0,117.0,231.0,144.0,154.0,191.0,131.0,147.0,142.0,142.0,144.0,113.0,105.0,84.0,119.0,90.0,51.0,40.0,31.0,25.0,18.0,9.0,8.0,2.0,4.0,1.0,13.87131615,15.11122812,13.75230082,614,441,656,568,856,496,454,458,656,580,856,550,1148,1046,1068,1130,1481,16.47893844,14.87429248,19.47146989,95.74146783,95.79896907,93.48766217,4514,5319,5079,69.64974541,70.01447940000001,66.77622929,922.6597252999999,1169.244595,1075.159283,23.659725299999998,21.24459485,29.15928332,118.7986652,98.43205575,141.5869981,936,14.44221571,33.93444781,2578,29.70023666,2259,64.76964770000001,101.0695187,126.09699769999999,46.7230444,1547,17.12992889,86.52061856,3357,13.10694072,33.78275248,1328,20.2560241,9.566903685,6.1364313379999995,9.789156627,25183.25722,26430011.76,7606.0,7577.0,7556.0,7520.0,7459.0,7482.0,7530.0,7576.0,7598.0,7571.0,7561.0,7597.0,7565.0,7393.0,7339.0,7201.0,6925.0,6677.0,6481.0,6327.0,6214.0,6087.0,6093.0,6030.0,5967.0,5904.0,5875.0,5379.0,4598.0,4579.0,4402.0,4451.0,4696.0,4876.0,4935.0,3351.0,26.43001175,126.7876848,186.71955380000003,184.487243,177.67680330000002,168.4070383,166.5530852,173.2500176,173.9688973,203.5186382,222.28518309999998,223.3824206,225.7660744,228.14972830000002,230.53338219999998,230.3063675,235.1115111,239.3869537,245.21366319999998,252.6294753,262.0127477,272.4554218,277.6767589,279.71989080000003,286.2276442,287.43838910000005,286.0763011,286.45465889999997,287.4762248,286.64383780000003,284.9033921,283.0872748,282.217052,284.5250343,285.8871222,286.6816735,287.778911,0,2,24,1,1,10243.175720000001,13420.81165,1725.5360420000002,2397.950922,2118.387699,31,160,0.013940151000000001,0,1.0,0.45,1.0,1.0
39043,2428,Cantabria,Cantabria,Meruelo,5,294,289,89.335146,64.58867099999999,0.17336,27.439709000000004,27.266347999999997,9.082972999999999,5.587239,8052.915470999999,12966.13959,4913.224118,10580.9891,1186.934426,1305.484252,5682.169304,4376.685052000001,3455.134248,1127.7172369999998,1894.648606,6155.142657,4260.494051,3938.7175850000003,1050.969958,1456.901787,5744.979603,4288.077815,3675.1373439999998,1050.786176,11.0,15.0,9.0,16.0,14.0,15.0,15,17,23,18,15,10,32,14,21,16,21,23,18,21,18,12.0,7.0,8.0,11.0,10.0,15.0,10,9,10,16,15,13,17,14,12,14,11,12,18,16,19,-1,8,1,5,4,0,5,8,13,2,0,-3,15,0,9,2,10,11,0,5,-1,53.65853659,76.14213198,46.875,77.29468599,64.81481481,76.14213198,78.94736842,92.89617486,133.72093020000003,106.5088757,90.90909091,60.60606061,202.5316456,85.88957055,131.25,88.88888889,125.0,136.90476189999998,115.38461540000002,142.8571429,76.38888889,58.53658537,35.53299492,41.66666667,53.14009662,46.2962963,76.14213198,52.63157895,49.18032787,58.13953488,94.67455621,90.90909091,78.78787879,107.5949367,85.88957055,75.0,77.77777778,63.95348837,71.42857143,115.38461540000002,108.8435374,131.9444444,-4.87804878,40.60913706,5.208333333,24.15458937,18.51851852,0,26.31578947,43.71584699,75.58139535,11.83431953,0.0,-18.18181818,94.93670886,0.0,56.25,11.11111111,58.13953488,65.47619048,0.0,34.01360544,-6.944444444,155,146,9,88,88,0,67,58,9,134,130,4,103,99,4,31,31,0,123,116,7,116,109,7,7,7,0,140,127,13,102,97,5,38,30,8,116,100,16,97,81,16,19,19,0,124,112,12,137,128,9,-13,-16,3,187,165,22,144,133,11,43,32,11,187,148,39,136,127,9,51,21,30,209,202,7,112,109,3,97,93,4,107.0,110.0,60.0,117.0,88.0,64.0,134.0,91.0,72.0,107.0,75.0,62.0,103.0,84.0,79.0,106.0,134.0,113.0,126.0,189.0,125.0,164.0,166.0,118.0,239.0,171.0,95.0,210.0,138.0,71.0,178.0,95.0,71.0,147.0,76.0,36.0,118.0,63.0,39.0,91.0,42.0,54.0,76.0,49.0,77.0,50.0,66.0,45.0,31.0,37.0,29.0,37.0,25.0,16.0,24.0,9.0,2.0,7.0,1.0,3.0,2.0,0.0,1.0,39.0,59.0,39.0,66.0,44.0,32.0,71.0,44.0,31.0,52.0,38.0,35.0,55.0,39.0,37.0,48.0,73.0,56.0,61.0,105.0,61.0,82.0,84.0,67.0,131.0,88.0,52.0,100.0,75.0,37.0,93.0,57.0,32.0,75.0,35.0,17.0,68.0,31.0,21.0,43.0,20.0,27.0,33.0,24.0,33.0,25.0,31.0,26.0,9.0,21.0,10.0,10.0,10.0,2.0,13.0,2.0,0.0,3.0,0.0,3.0,0.0,0.0,0.0,68.0,51.0,21.0,51.0,44.0,32.0,63.0,47.0,41.0,55.0,37.0,27.0,48.0,45.0,42.0,58.0,61.0,57.0,65.0,84.0,64.0,82.0,82.0,51.0,108.0,83.0,43.0,110.0,63.0,34.0,85.0,38.0,39.0,72.0,41.0,19.0,50.0,32.0,18.0,48.0,22.0,27.0,43.0,25.0,44.0,25.0,35.0,19.0,22.0,16.0,19.0,27.0,15.0,14.0,11.0,7.0,2.0,4.0,1.0,0.0,2.0,0.0,1.0,15.90909091,16.91047396,16.46734131,126,94,121,142,182,182,101,102,121,147,182,176,289,358,227,229,318,18.42532468,13.39964892,14.6274149,100.6514658,106.1519903,98.17684594,809,1191,1498,65.66558442,69.68987712,68.90524379,224.0593325,308.22753989999995,379.22830439999996,28.05933251,19.22753988,21.22830441,115.81632649999999,79.23875433,88.82681564,1706,138.474026,38.85313049,664,33.99264029,739,62.90322581,84.0,110.28037379999999,50.16286645,308,19.48051948,98.79372738,819,13.43101343,39.10665451,429,24.94172494,6.818181817999999,6.227106227,15.85081585,16195.355090000001,16319686.26,2174.0,2086.0,2028.0,1982.0,1985.0,1965.0,1922.0,1912.0,1878.0,1798.0,1742.0,1709.0,1652.0,1564.0,1467.0,1416.0,1372.0,1321.0,1232.0,1173.0,1125.0,1121.0,1081.0,1028.0,991.5,955.0,911.0,833.0,1016.0,1174.0,1144.0,1426.0,1200.0,1001.0,804.0,849.0,16.31968689,52.02305692,49.26565108,61.33696111,73.5308225,87.37912741,70.09938412,71.93765468,62.25609639,51.04264595,55.82214942,58.51827958,60.75484209,62.99140461,66.23901594,68.69004336,68.93514609999998,71.876379,75.49164444,80.94518044,84.0702404,86.76637055,89.89143051,95.835172,101.2274323,104.7201464,106.742244,110.1736824,115.07573719999999,117.1591105,117.7718674,120.40672179999999,121.63223559999999,121.4484085,124.26709,127.82107979999999,133.21334009999998,0,1,0,1,1,12099.008829999999,3874.730807,5799.891329,2188.6873649999998,1877.981555,36,207,0.001456171,0,0.68,0.0,1.0,1.0
39044,2429,Cantabria,Cantabria,Miengo,-6,165,171,30.224335999999997,26.098726,0.0,24.13191,24.13191,4.582161,3.6226480000000003,6007.560217,11443.643759999999,5436.083544,8647.202454,1055.701806,698.526295,6567.562712,5869.036417,2906.12707,1182.307323,7.8803220000000005,6498.2058560000005,6490.3255340000005,2649.900909,1219.133063,36.755425,5583.530734,5546.775309000001,1929.5729489999999,1159.045809,20.0,37.0,36.0,39.0,33.0,34.0,38,36,49,50,37,39,47,45,59,46,39,52,39,48,32,37.0,19.0,35.0,36.0,42.0,23.0,37,33,22,43,40,36,41,28,48,36,44,34,48,41,57,-17,18,1,3,-9,11,1,3,27,7,-3,3,6,17,11,10,-5,18,-9,7,-25,52.91005291,101.6483516,106.8249258,122.6415094,93.75,96.59090909,108.88252150000001,108.43373490000002,155.5555556,161.8122977,120.12987009999999,133.5616438,165.49295769999998,166.0516605,228.6821705,193.2773109,180.5555556,240.74074069999998,190.2439024,190.4761905,80.64516129,97.88359788,52.1978022,103.8575668,113.2075472,119.3181818,65.34090909,106.017192,99.39759036,69.84126984,139.1585761,129.87012990000002,123.2876712,144.3661972,103.3210332,186.0465116,151.26050419999999,194.6902655,157.4074074,234.1463415,162.69841269999998,229.8387097,-44.97354497,49.45054945,2.96735905,9.433962264,-25.56818182,31.25,2.8653295130000003,9.036144578,85.71428571,22.65372168,-9.74025974,10.273972599999999,21.12676056,62.73062731,42.63565891,42.01680672,-22.12389381,83.33333333,-43.90243902,27.77777778,-100.80645159999999,243,238,5,279,259,20,-36,-21,-15,223,212,11,262,241,21,-39,-29,-10,301,288,13,271,256,15,30,32,-2,340,326,14,282,272,10,58,54,4,234,218,16,287,275,12,-53,-57,4,312,295,17,280,273,7,32,22,10,347,322,25,313,307,6,34,15,19,406,372,34,269,266,3,137,106,31,439,414,25,243,239,4,196,175,21,216.0,222.0,158.0,209.0,170.0,138.0,219.0,172.0,129.0,179.0,144.0,200.0,193.0,226.0,267.0,200.0,330.0,308.0,343.0,468.0,348.0,423.0,438.0,349.0,557.0,414.0,315.0,455.0,342.0,293.0,433.0,330.0,239.0,379.0,280.0,210.0,345.0,252.0,146.0,265.0,168.0,210.0,241.0,172.0,194.0,147.0,183.0,153.0,110.0,133.0,94.0,86.0,67.0,51.0,51.0,25.0,11.0,7.0,4.0,2.0,1.0,0.0,0.0,108.0,121.0,77.0,117.0,86.0,71.0,120.0,93.0,66.0,98.0,77.0,100.0,105.0,106.0,145.0,86.0,159.0,164.0,184.0,254.0,178.0,218.0,240.0,185.0,288.0,210.0,162.0,251.0,189.0,152.0,212.0,168.0,133.0,208.0,149.0,110.0,171.0,136.0,75.0,145.0,77.0,89.0,126.0,73.0,91.0,68.0,77.0,63.0,46.0,49.0,41.0,29.0,17.0,15.0,13.0,9.0,2.0,0.0,0.0,1.0,1.0,0.0,0.0,108.0,101.0,81.0,92.0,84.0,67.0,99.0,79.0,63.0,81.0,67.0,100.0,88.0,120.0,122.0,114.0,171.0,144.0,159.0,214.0,170.0,205.0,198.0,164.0,269.0,204.0,153.0,204.0,153.0,141.0,221.0,162.0,106.0,171.0,131.0,100.0,174.0,116.0,71.0,120.0,91.0,121.0,115.0,99.0,103.0,79.0,106.0,90.0,64.0,84.0,53.0,57.0,50.0,36.0,38.0,16.0,9.0,7.0,4.0,1.0,0.0,0.0,0.0,11.14023591,12.42290749,12.7297885,413,211,450,264,480,299,302,214,450,300,480,345,564,644,715,752,908,18.74180865,16.56387665,17.94821111,101.31926120000001,101.7777778,105.23326570000002,2675,3224,3507,70.11795544,71.01321586,69.32200040000001,451.728972,587.325062,669.891075,26.72897196,23.32506203,25.89107499,168.23529409999998,133.3333333,140.9937888,631,16.53997379,36.60792952,1662,35.14528563,1778,73.0,175.0,192.73743019999998,49.28759894,934,16.91648822,89.77777778,2020,10.99009901,39.71602434,979,22.06332993,8.672376874,5.0,11.03166496,27297.00179,24416237.28,5059.0,4891.0,4741.0,4713.0,4676.0,4741.0,4675.0,4626.0,4654.0,4677.0,4648.0,4540.0,4495.0,4296.0,4135.0,3986.0,3867.0,3860.0,3815.0,3762.0,3682.0,3544.0,3363.0,3466.0,3451.5,3437.0,2964.0,3000.0,3237.0,3381.0,2976.0,2449.0,2189.0,1633.0,1502.0,1275.0,24.41623688,52.21934921,61.51644119,66.88172335,89.65345524,100.30210679999999,121.88610449999999,138.47342719999997,132.5757125,122.86905700000001,121.39462830000001,140.76698290000002,141.36085,141.95471719999998,137.7362129,145.1493126,150.8012893,154.0777974,156.2484841,158.09152,158.37821440000002,163.25202040000002,169.3545169,175.9484896,184.0988037,185.9418396,190.3651256,191.55285980000002,190.61086369999998,189.46408590000001,191.4709471,194.17406640000002,191.5119035,193.0272885,194.17406640000002,200.3175192,207.1981864,0,0,2,0,3,6207.400390999999,2877.9512059999997,1919.604406,3552.7498950000004,1154.985406,117,554,0.000589546,0,0.98,0.0,1.0,1.0
39045,2430,Cantabria,Cantabria,Miera,143,945,802,537.673054,166.579695,0.0,53.166782,53.166782,19.143392000000002,8.915267,11870.7805,18734.864980000002,6864.084476999999,15233.680859999999,1572.009115,5667.799407,12532.006159999999,6864.206748999999,8955.996258,1584.032273,5610.075247,12468.30706,6858.231812999999,9041.449741,1554.5316810000002,3896.761694,10305.86308,6409.10139,7046.458422,1544.7070210000002,2.0,0.0,1.0,1.0,2.0,2.0,1,0,5,0,1,3,3,0,0,2,3,0,1,2,1,8.0,15.0,4.0,10.0,7.0,3.0,11,8,6,9,4,6,8,9,9,9,4,7,8,5,5,-6,-15,-3,-9,-5,-1,-10,-8,-1,-9,-3,-3,-5,-9,-9,-7,-1,-7,-7,-3,-4,2.026342452,0,1.061571125,1.078748652,2.227171492,2.249718785,1.140250855,0.0,5.861664713,0.0,1.216545012,3.571428571,3.6900369,0.0,0.0,2.5445292619999997,4.195804196,0.0,1.418439716,2.9629629630000003,3.0816640989999997,8.105369807,15.41623844,4.246284501,10.78748652,7.795100223,3.374578178,12.54275941,9.248554913,7.033997655,10.96224117,4.866180049,7.142857143,9.840098401,10.93560146,11.52368758,11.45038168,5.449591281,9.79020979,11.34751773,7.407407407000001,7.704160247000001,-6.079027356,-15.41623844,-3.184713376,-9.708737864,-5.567928731,-1.124859393,-11.40250855,-9.248554913,-1.172332943,-10.96224117,-3.6496350360000003,-3.571428571,-6.150061501000001,-10.93560146,-11.52368758,-8.905852417,-1.36239782,-9.79020979,-9.929078014,-4.444444444,-6.163328197,7,5,2,9,8,1,-2,-3,1,17,17,0,14,13,1,3,4,-1,27,27,0,27,21,6,0,6,-6,8,3,5,14,14,0,-6,-11,5,8,8,0,9,8,1,-1,0,-1,13,13,0,13,8,5,0,5,-5,18,17,1,20,20,0,-2,-3,1,15,15,0,11,10,1,4,5,-1,24,21,3,14,13,1,10,8,2,10.0,8.0,6.0,10.0,3.0,11.0,11.0,3.0,23.0,5.0,14.0,18.0,7.0,22.0,30.0,11.0,30.0,31.0,25.0,28.0,27.0,23.0,35.0,27.0,31.0,25.0,37.0,34.0,38.0,29.0,20.0,30.0,39.0,32.0,34.0,31.0,37.0,42.0,26.0,33.0,25.0,25.0,39.0,22.0,37.0,19.0,29.0,37.0,14.0,29.0,27.0,13.0,17.0,18.0,10.0,6.0,4.0,2.0,2.0,1.0,0.0,0.0,2.0,8.0,6.0,4.0,5.0,1.0,5.0,8.0,1.0,11.0,3.0,6.0,10.0,2.0,12.0,15.0,7.0,16.0,18.0,13.0,19.0,13.0,15.0,18.0,14.0,18.0,16.0,18.0,16.0,18.0,17.0,14.0,16.0,16.0,14.0,18.0,21.0,20.0,24.0,17.0,15.0,17.0,11.0,20.0,11.0,14.0,11.0,9.0,16.0,8.0,13.0,17.0,3.0,8.0,5.0,2.0,2.0,2.0,0.0,1.0,0.0,0.0,0.0,1.0,2.0,2.0,2.0,5.0,2.0,6.0,3.0,2.0,12.0,2.0,8.0,8.0,5.0,10.0,15.0,4.0,14.0,13.0,12.0,9.0,14.0,8.0,17.0,13.0,13.0,9.0,19.0,18.0,20.0,12.0,6.0,14.0,23.0,18.0,16.0,10.0,17.0,18.0,9.0,18.0,8.0,14.0,19.0,11.0,23.0,8.0,20.0,21.0,6.0,16.0,10.0,10.0,9.0,13.0,8.0,4.0,2.0,2.0,1.0,1.0,0.0,0.0,1.0,8.230452675,3.1674208139999998,8.031088083,85,20,69,6,71,10,66,20,69,8,71,21,14,31,151,130,130,31.06995885,29.41176471,33.67875648,101.659751,110.4761905,109.78260870000001,295,298,225,60.69958848,67.42081448,58.29015544,91.18644068,57.62416107,88.77777778,51.18644068,43.62416107,57.77777778,377.5,928.5714286,419.3548387,1041,214.19753089999998,28.50678733,126,29.2746114,113,144.4444444,300.0,740.0,36.51452282,88,6.818181817999999,73.33333333,154,5.194805195,31.52173913,58,17.24137931,2.272727273,1.298701299,3.448275862,24235.42289,34113722.12,386.0,381.0,380.0,389.0,393.0,395.0,410.0,417.0,420.0,424.0,439.0,442.0,462.0,455.0,453.0,468.0,475.0,479.0,486.0,496.0,516.0,532.0,543.0,548.0,564.0,580.0,614.0,718.0,1011.0,1107.0,1187.0,1141.0,1313.0,1389.0,1413.0,1489.0,34.11372375,43.64812269,41.420280299999995,40.71675112,38.48890873,33.44694963,34.79538055,32.45028329,29.63616658,21.04724788,17.99862145,17.00195511,16.53293566,16.06391621,15.91734763,15.59489676,15.12587731,14.53960299,14.24646584,14.04126983,13.92401496,13.71881895,13.27911322,13.33774065,13.54293666,12.95666234,12.8687212,12.42901546,12.3117606,12.22381945,12.01862344,11.57891771,11.52029027,11.40303541,11.13921197,11.16852569,11.31509426,0,0,2,0,2,21069.51876,7275.6984840000005,2594.341493,6977.069135,1756.1369960000002,6,40,3.66655e-05,0,0.0,0.0,1.0,0.05
39046,2431,Cantabria,Cantabria,Molledo,191,1238,1047,560.128837,229.72225099999997,0.122584,42.514904,42.39232,14.108803,7.064802,11312.880009999999,22346.00304,11033.123029999999,18213.80289,1902.264826,25.482726,6548.910442,6523.427715,3297.936751,1697.7937329999997,20.372038,10263.15933,10242.78729,4387.859483,2768.000703,16.543460999999997,8993.941614,8977.398153,3668.813602,2237.450917,11.0,8.0,7.0,6.0,7.0,10.0,7,13,6,8,12,7,9,15,13,8,9,8,6,2,8,27.0,23.0,26.0,28.0,17.0,33.0,27,23,23,37,21,22,33,23,26,30,32,29,31,24,29,-16,-15,-19,-22,-10,-23,-20,-10,-17,-29,-9,-15,-24,-8,-13,-22,-23,-21,-25,-22,-21,39.56834532,30.07518797,24.82269504,21.66064982,25.64102564,36.900369,26.92307692,49.61832061,22.3880597,29.5202952,45.11278195,27.45098039,35.57312253,60.24096386,53.27868852,33.05785124,40.90909091,36.36363636,29.26829268,10.1010101,55.83756345,97.12230216,86.46616541,92.19858156,101.0830325,62.27106227,121.7712177,103.8461538,87.78625954,85.82089552,136.5313653,78.94736842,86.2745098,130.43478259999998,92.36947791,106.557377,123.96694209999998,144.7963801,131.8181818,151.2195122,121.21212120000001,147.20812180000001,-57.55395683,-56.39097744,-67.37588652,-79.42238267,-36.63003663,-84.87084871,-76.92307692,-38.16793893,-63.43283582,-107.01107009999998,-33.83458647,-58.82352941,-94.86166008,-32.12851406,-53.27868852,-90.90909091,-104.07239820000001,-95.45454545,-121.95121950000001,-111.1111111,-106.5989848,80,76,4,49,49,0,31,27,4,72,67,5,64,63,1,8,4,4,43,43,0,52,48,4,-9,-5,-4,57,57,0,58,48,10,-1,9,-10,58,50,8,40,40,0,18,10,8,51,46,5,62,62,0,-11,-16,5,40,40,0,51,48,3,-11,-8,-3,84,83,1,64,63,1,20,20,0,70,64,6,50,49,1,20,15,5,33.0,35.0,40.0,52.0,39.0,49.0,42.0,50.0,55.0,41.0,42.0,118.0,54.0,89.0,149.0,55.0,128.0,124.0,62.0,97.0,101.0,97.0,88.0,88.0,116.0,90.0,122.0,96.0,102.0,137.0,89.0,144.0,148.0,107.0,142.0,102.0,139.0,119.0,79.0,128.0,92.0,110.0,120.0,80.0,171.0,89.0,127.0,105.0,61.0,107.0,85.0,60.0,58.0,52.0,44.0,17.0,16.0,9.0,8.0,5.0,0.0,1.0,0.0,15.0,10.0,15.0,29.0,18.0,17.0,19.0,23.0,27.0,18.0,22.0,69.0,26.0,53.0,77.0,34.0,69.0,67.0,36.0,57.0,61.0,53.0,38.0,43.0,68.0,55.0,65.0,48.0,45.0,70.0,48.0,76.0,82.0,51.0,77.0,56.0,70.0,64.0,37.0,70.0,50.0,49.0,60.0,33.0,78.0,41.0,54.0,49.0,29.0,48.0,25.0,15.0,20.0,15.0,11.0,2.0,2.0,2.0,0.0,1.0,0.0,0.0,0.0,18.0,25.0,25.0,23.0,21.0,32.0,23.0,27.0,28.0,23.0,20.0,49.0,28.0,36.0,72.0,21.0,59.0,57.0,26.0,40.0,40.0,44.0,50.0,45.0,48.0,35.0,57.0,48.0,57.0,67.0,41.0,68.0,66.0,56.0,65.0,46.0,69.0,55.0,42.0,58.0,42.0,61.0,60.0,47.0,93.0,48.0,73.0,56.0,32.0,59.0,60.0,45.0,38.0,37.0,33.0,15.0,14.0,7.0,8.0,4.0,0.0,1.0,0.0,7.75862069,7.49244713,8.500669344,325,85,283,73,283,64,219,59,283,51,283,63,124,127,544,490,511,29.31034483,29.60725076,34.20348059,95.16298633,96.78953627,98.93475366,1168,1041,856,62.93103448,62.90030211,57.29585007,190.5753425,171.0701249,186.69626169999998,46.57534247,47.07012488,59.69626168,377.77777779999997,395.1612903,402.3622047,228,12.28448276,22.77945619,377,24.83266399,371,66.94915254,283.3333333,339.02439019999997,40.16824395,382,10.47120419,63.49583829,534,6.554307116,31.29161119,235,14.04255319,6.544502617999999,4.68164794,7.659574468,46044.332089999996,70960862.11,1494.0,1507.0,1504.0,1544.0,1585.0,1589.0,1595.0,1612.0,1613.0,1610.0,1634.0,1655.0,1679.0,1730.0,1742.0,1770.0,1836.0,1858.0,1856.0,1884.0,1914.0,1935.0,1955.0,1984.0,2004.0,2024.0,2157.0,2318.0,2615.0,3115.0,2951.0,2999.0,2849.0,2870.0,2648.0,2692.0,70.96086121,37.93640542,37.31634531,40.44483045,40.14889267,42.26273398,41.58630476,43.89743793,36.85130022,32.66589442,30.39703808,28.52276545,28.24091994,27.95907443,27.55039844,27.26855293,26.97261515,26.54984689,26.15526318,26.18344773,25.87341767,24.94332749,24.54874378,24.37963647,23.66093043,23.32271582,23.02677803,22.68856342,22.73084025,22.71674797,22.47717929,22.39262564,22.33625654,21.75847325,21.19478223,21.23705905,21.05385947,0,1,0,0,3,25924.806,6208.478746,11117.39595,10278.88732,2836.6684219999997,10,80,0.00012112,0,0.95,0.07,1.0,1.0
39047,2432,Cantabria,Cantabria,Noja,-1,223,224,27.317414000000003,43.395443,0.0,37.655891,37.655891,5.200383,7.967784,3109.532843,8954.13992,5844.607077000001,6403.597314,1425.1292640000001,4229.100493,8051.880268999999,3822.779775,6078.895933,898.59779,5815.839237,9527.514102,3711.674865,7476.714454000001,903.3828710000001,4336.180579999999,8161.4728829999995,3825.2923020000003,6190.480163,895.9788279999999,21.0,21.0,22.0,23.0,31.0,33.0,22,29,43,26,24,22,13,10,11,15,17,22,14,15,15,14.0,16.0,11.0,15.0,24.0,17.0,22,14,21,18,14,23,20,15,15,24,24,22,24,24,25,7,5,11,8,7,16,0,15,22,8,10,-1,-7,-5,-4,-9,-7,0,-10,-9,-10,55.40897098,55.85106383,61.45251397,65.9025788,88.06818182,94.82758621,62.14689266,88.95705521,134.375,80.99688474,77.92207792,73.57859532,44.36860068,34.96503497,39.71119134,54.34782609,66.40625,85.9375,55.11811024,60.24096386,85.36585366,36.93931398,42.55319149,30.72625698,42.97994269,68.18181818,48.85057471,62.14689266,42.94478528,65.625,56.07476636,45.45454545,76.92307692,68.25938567,52.44755245,54.15162455,86.95652174,91.95402299,85.9375,94.48818898,96.38554217,101.62601629999999,18.46965699,13.29787234,30.72625698,22.9226361,19.88636364,45.97701149,0.0,46.01226994,68.75,24.92211838,32.46753247,-3.344481605,-23.89078498,-17.48251748,-14.44043321,-32.60869565,-26.81992337,0.0,-39.37007874,-36.14457831,-40.6504065,134,99,35,189,163,26,-55,-64,9,106,95,11,129,116,13,-23,-21,-2,190,181,9,149,125,24,41,56,-15,139,111,28,141,130,11,-2,-19,17,138,123,15,141,127,14,-3,-4,1,154,127,27,165,151,14,-11,-24,13,198,158,40,175,157,18,23,1,22,211,169,42,172,158,14,39,11,28,202,187,15,131,118,13,71,69,2,95.0,171.0,101.0,87.0,124.0,115.0,145.0,101.0,121.0,140.0,135.0,125.0,122.0,135.0,144.0,122.0,194.0,205.0,150.0,256.0,199.0,202.0,240.0,215.0,243.0,213.0,188.0,212.0,208.0,144.0,223.0,172.0,126.0,219.0,144.0,97.0,198.0,122.0,74.0,149.0,100.0,102.0,115.0,92.0,97.0,87.0,94.0,52.0,59.0,64.0,46.0,44.0,33.0,23.0,27.0,14.0,8.0,9.0,1.0,0.0,2.0,0.0,0.0,48.0,92.0,60.0,51.0,67.0,55.0,74.0,63.0,56.0,77.0,63.0,66.0,68.0,61.0,69.0,52.0,103.0,100.0,71.0,124.0,102.0,106.0,120.0,112.0,120.0,116.0,96.0,106.0,107.0,75.0,119.0,88.0,69.0,110.0,74.0,46.0,98.0,58.0,34.0,83.0,48.0,53.0,52.0,45.0,45.0,39.0,42.0,22.0,19.0,28.0,20.0,17.0,13.0,7.0,9.0,4.0,1.0,2.0,0.0,0.0,0.0,0.0,0.0,47.0,79.0,41.0,36.0,57.0,60.0,71.0,38.0,65.0,63.0,72.0,59.0,54.0,74.0,75.0,70.0,91.0,105.0,79.0,132.0,97.0,96.0,120.0,103.0,123.0,97.0,92.0,106.0,101.0,69.0,104.0,84.0,57.0,109.0,70.0,51.0,100.0,64.0,40.0,66.0,52.0,49.0,63.0,47.0,52.0,48.0,52.0,30.0,40.0,36.0,26.0,27.0,20.0,16.0,18.0,10.0,7.0,7.0,1.0,0.0,2.0,0.0,0.0,15.44454629,15.15499426,12.33962264,180,166,218,174,271,154,148,171,218,222,271,173,396,327,328,398,492,15.03208066,15.23153463,18.56603774,99.45155393,101.464919,99.39804364,1517,1819,1831,69.52337305,69.61347111,69.09433962,358.6216216,417.8801539,353.8705625,21.62162162,21.88015393,26.87056253,97.32937685,100.5050505,150.4587156,455,20.85242896,35.09376196,917,30.45283019,807,59.2,90.37037037,141.4285714,49.81718464,545,18.53211009,90.43947571,1173,14.57800512,37.17080512,494,19.23076923,7.52293578,6.73486786,9.51417004,19105.8407,9236183.763,2650.0,2588.0,2556.0,2539.0,2553.0,2562.0,2587.0,2551.0,2580.0,2653.0,2645.0,2613.0,2635.0,2555.0,2425.0,2292.0,2337.0,2218.0,2182.0,2135.0,2073.0,2019.0,1981.0,1865.0,1870.5,1876.0,1562.0,1273.0,1170.0,1058.0,980.0,983.0,940.0,786.0,641.0,655.0,9.23618412,70.91673265,69.40095516,85.10007919,101.7736316,106.42923390000001,106.1044244,114.54947050000001,126.67569040000001,137.8274819,169.11746019999998,203.11418390000003,202.5186999,201.9232159,214.4825151,218.5967683,224.4433386,231.15606749999998,236.24474909999998,240.14246260000002,253.0265713,248.15442940000003,262.5543156,276.6293923,285.2909779,282.9090419,286.37367610000007,287.2398347,279.3361378,276.196313,280.09402650000004,277.38728100000003,276.4128526,274.8970751,276.7376621,280.20229639999997,286.9150252,0,2,4,0,1,9468.170051000001,5161.692572999999,1485.303578,4817.51961,1158.552989,159,781,5.46123e-05,0,0.96,0.1,1.0,1.0
39049,2433,Cantabria,Cantabria,Pe√±arrubia,38,1534,1496,690.1920349999999,281.599027,0.7456109999999999,61.363567,60.61795600000001,24.7031,11.780254,38164.44567,49129.55518,10965.1095,43872.31787,2438.415584,22.326244,5864.254209000001,5841.927965,2609.11926,1299.816615,10329.00136,19672.03471,9343.033346,14646.067469999998,2065.992052,10115.21647,19711.36878,9596.152312,14323.389959999999,2175.284554,0.0,0.0,5.0,3.0,1.0,1.0,1,2,3,1,0,2,3,1,0,0,1,2,0,0,1,3.0,8.0,5.0,7.0,4.0,10.0,3,3,2,1,5,4,10,2,2,4,4,2,2,4,3,-3,-8,0,-4,-3,-9,-2,-1,1,0,-5,-2,-7,-1,-2,-4,-3,0,-2,-4,-2,0,0,7.72797527,4.81540931,1.592356688,1.615508885,1.6474464580000001,3.3500837519999997,5.067567568,1.7182130580000001,0.0,3.490401396,5.291005291,1.84501845,0.0,0.0,2.0283975659999998,4.0567951319999995,0.0,0.0,0.0,4.457652303,12.03007519,7.72797527,11.23595506,6.369426752,16.15508885,4.9423393739999995,5.0251256280000005,3.3783783780000003,1.7182130580000001,8.665511265,6.980802792,17.6366843,3.6900369,3.80952381,7.90513834,8.368200837,4.0567951319999995,4.140786749,8.368200837,6.396588486000001,-4.457652303,-12.03007519,0,-6.420545746,-4.777070064,-14.53957997,-3.2948929160000002,-1.6750418759999999,1.6891891890000001,0.0,-8.665511265,-3.490401396,-12.34567901,-1.84501845,-3.80952381,-7.90513834,-6.276150628,0.0,-4.140786749,-8.368200837,-4.264392324,23,23,0,20,20,0,3,3,0,16,13,3,11,10,1,5,3,2,17,16,1,20,20,0,-3,-4,1,18,18,0,17,17,0,1,1,0,7,5,2,19,19,0,-12,-14,2,19,16,3,20,20,0,-1,-4,3,20,11,9,17,16,1,3,-5,8,19,12,7,14,14,0,5,-2,7,18,17,1,14,13,1,4,4,0,5.0,5.0,8.0,4.0,11.0,4.0,2.0,4.0,4.0,3.0,3.0,6.0,8.0,10.0,13.0,9.0,19.0,25.0,12.0,24.0,26.0,21.0,17.0,33.0,23.0,42.0,21.0,18.0,31.0,16.0,34.0,22.0,17.0,34.0,13.0,33.0,32.0,33.0,20.0,9.0,29.0,30.0,31.0,23.0,33.0,28.0,32.0,28.0,15.0,26.0,19.0,18.0,16.0,10.0,10.0,4.0,6.0,2.0,1.0,3.0,0.0,1.0,1.0,1.0,4.0,5.0,2.0,6.0,2.0,2.0,2.0,4.0,1.0,3.0,3.0,5.0,5.0,7.0,6.0,9.0,11.0,8.0,9.0,12.0,13.0,9.0,21.0,12.0,24.0,13.0,8.0,22.0,8.0,20.0,12.0,10.0,22.0,4.0,19.0,19.0,19.0,11.0,4.0,14.0,16.0,15.0,15.0,18.0,16.0,13.0,11.0,8.0,13.0,5.0,4.0,6.0,4.0,3.0,2.0,0.0,1.0,0.0,0.0,0.0,0.0,0.0,4.0,1.0,3.0,2.0,5.0,2.0,0.0,2.0,0.0,2.0,0.0,3.0,3.0,5.0,6.0,3.0,10.0,14.0,4.0,15.0,14.0,8.0,8.0,12.0,11.0,18.0,8.0,10.0,9.0,8.0,14.0,10.0,7.0,12.0,9.0,14.0,13.0,14.0,9.0,5.0,15.0,14.0,16.0,8.0,15.0,12.0,19.0,17.0,7.0,13.0,14.0,14.0,10.0,6.0,7.0,2.0,6.0,1.0,1.0,3.0,0.0,1.0,1.0,4.494382022,5.4644808739999995,3.459119497,76,5,69,8,62,6,54,11,69,12,62,5,20,11,130,132,113,36.51685393,36.06557377,35.53459119,102.2727273,109.1428571,114.8648649,210,214,194,58.98876404,58.46994536,61.00628931,77.90476190000001,81.68224299,69.24742268,61.9047619,61.68224299,58.24742268,812.5,660.0,1027.272727,618,173.5955056,31.14754098,114,23.27044025,74,333.3333333,1100.0,1066.666667,38.06818182,67,11.94029851,65.71428571,115,4.347826087,30.40540541,45,11.11111111,4.47761194,0.869565217,8.888888889,37488.24173,53047617.89,318.0,319.0,319.0,321.0,332.0,349.0,351.0,357.0,353.0,367.0,373.0,366.0,367.0,365.0,372.0,380.0,374.0,375.0,356.0,324.0,297.0,284.0,284.0,286.0,292.0,298.0,329.0,420.0,582.0,770.0,901.0,934.0,906.0,1002.0,1026.0,872.0,53.04761887,16.4380611,19.34111317,18.88868947,17.07899467,17.60682232,16.98473974,14.51526037,10.97127472,7.917414749,6.201974887,5.617594274,5.504488349,5.391382424,5.353680449,5.353680449,5.5987432870000005,6.107719949,6.710951549,7.069120311,7.050269323999999,7.163375249,7.012567348999999,6.880610436,6.9183124110000005,6.899461424,7.031418336000001,6.9183124110000005,6.654398587,6.729802537,6.616696612,6.578994637,6.258527849,6.051166987,6.013465012,6.013465012,5.994614024,0,0,0,0,4,42433.23005,5787.680738,7385.676454,7505.054518000001,1982.733227,9,56,0.00256974,0,0.17,0.17,1.0,1.0
39050,2434,Cantabria,Cantabria,Pesaguero,438,1950,1512,1061.20289,290.508132,0.346717,55.42334,55.076622,20.81203,7.768634,27223.337760000002,38210.530719999995,10987.19296,33122.27063,2796.160921,4966.984279,15562.985359999999,10596.00108,10170.34782,2516.588813,26851.1672,37276.9154,10425.7482,31906.64228,2328.0520079999997,20652.23351,30265.10525,9612.871743000002,25369.65109,2066.9930510000004,2.0,0.0,4.0,0.0,3.0,1.0,1,4,3,2,3,5,4,1,3,0,1,0,3,0,0,8.0,4.0,7.0,4.0,9.0,4.0,15,7,7,4,2,8,8,7,8,5,5,3,1,10,5,-6,-4,-3,-4,-6,-3,-14,-3,-4,-2,1,-3,-4,-6,-5,-5,-4,-3,2,-10,-5,12.57861635,0,25.80645161,0,19.60784314,6.849315068,6.756756757000001,28.36879433,21.73913043,15.15151515,23.62204724,42.01680672,33.89830508,8.620689655,26.31578947,0.0,8.928571429,0.0,27.52293578,0.0,18.34862385,50.31446541,25.1572327,45.16129032,26.49006623,58.82352941,27.39726027,101.35135140000001,49.64539007,50.72463768,30.303030300000003,15.7480315,67.22689076,67.79661017,60.34482759,70.17543859999999,42.73504274,43.47826087,26.78571429,9.174311927,90.90909091,45.87155963,-37.73584906,-25.1572327,-19.35483871,-26.49006623,-39.21568627,-20.54794521,-94.59459459,-21.27659574,-28.98550725,-15.15151515,7.874015748,-25.21008403,-33.89830508,-51.72413793,-43.85964912,-42.73504274,-34.782608700000004,-26.78571429,18.34862385,-90.90909091,-45.87155963,13,13,0,25,22,3,-12,-9,-3,18,18,0,10,10,0,8,8,0,9,9,0,18,18,0,-9,-9,0,8,7,1,5,5,0,3,2,1,7,5,2,17,15,2,-10,-10,0,9,9,0,18,18,0,-9,-9,0,16,16,0,12,12,0,4,4,0,20,19,1,10,10,0,10,9,1,12,12,0,6,6,0,6,6,0,4.0,12.0,7.0,10.0,11.0,4.0,15.0,8.0,12.0,8.0,13.0,13.0,7.0,9.0,9.0,9.0,7.0,16.0,10.0,26.0,23.0,8.0,18.0,17.0,23.0,16.0,27.0,23.0,33.0,22.0,25.0,18.0,25.0,28.0,27.0,21.0,21.0,22.0,24.0,29.0,24.0,36.0,20.0,27.0,33.0,22.0,24.0,34.0,12.0,20.0,26.0,13.0,19.0,17.0,6.0,8.0,6.0,1.0,2.0,1.0,0.0,1.0,0.0,1.0,5.0,4.0,3.0,7.0,3.0,7.0,4.0,5.0,6.0,8.0,7.0,3.0,6.0,7.0,5.0,5.0,10.0,5.0,15.0,17.0,5.0,11.0,9.0,13.0,12.0,18.0,13.0,22.0,13.0,17.0,14.0,16.0,20.0,16.0,10.0,16.0,13.0,13.0,16.0,12.0,18.0,12.0,16.0,15.0,9.0,14.0,21.0,9.0,10.0,10.0,8.0,6.0,5.0,3.0,1.0,2.0,0.0,0.0,0.0,0.0,0.0,0.0,3.0,7.0,3.0,7.0,4.0,1.0,8.0,4.0,7.0,2.0,5.0,6.0,4.0,3.0,2.0,4.0,2.0,6.0,5.0,11.0,6.0,3.0,7.0,8.0,10.0,4.0,9.0,10.0,11.0,9.0,8.0,4.0,9.0,8.0,11.0,11.0,5.0,9.0,11.0,13.0,12.0,18.0,8.0,11.0,18.0,13.0,10.0,13.0,3.0,10.0,16.0,5.0,13.0,12.0,3.0,7.0,4.0,1.0,2.0,1.0,0.0,1.0,0.0,6.166219839,8.985507246000001,9.863945578,82,11,66,15,46,18,71,12,66,16,46,11,31,29,153,125,103,41.01876676,36.23188406,35.03401361,119.4117647,133.1081081,139.02439019999997,197,189,162,52.8150134,54.782608700000004,55.10204082,100.6649746,97.13756614,92.58024691,77.66497462,66.13756614,63.58024691,665.2173912999999,403.2258065,355.1724138,102,27.345844500000002,26.95652174,93,21.76870748,64,184.6153846,169.23076919999997,262.5,40.0,68,10.29411765,60.13513514,89,13.48314607,30.08130081,37,10.81081081,4.4117647060000005,7.865168539,8.108108108,40415.27489,69923098.82,294.0,295.0,292.0,285.0,298.0,311.0,312.0,326.0,324.0,340.0,348.0,345.0,349.0,344.0,346.0,360.0,371.0,384.0,373.0,394.0,394.0,402.0,405.0,403.0,412.0,421.0,410.0,497.0,702.0,980.0,1227.0,1310.0,1268.0,1323.0,1343.0,1285.0,69.9230957,18.3773328,19.20681552,18.920787,18.13420855,18.73486846,17.54785007,14.01539778,10.03960126,7.1078088720000006,5.8635847839999995,6.020900472999999,5.892187636,5.7634748,5.792077652000001,5.749173373,5.634761963,5.634761963,5.3344320110000005,5.4917476999999995,5.305829158,5.148513469,4.9482935,4.919690648,4.991197779,4.933992074,4.976896353,4.862484943,4.633662122,4.662264974,4.462045006,4.44774358,4.2618250380000005,4.075906496,4.17601648,4.2189207589999995,4.204619333,0,0,0,0,1,49745.777910000004,7371.463427,10513.80909,11554.03818,3700.8049590000005,10,60,2.48301e-05,0,0.0,0.0,1.0,1.0
39053,2435,Cantabria,Cantabria,Polaciones,750,2109,1359,1257.1757929999999,273.280847,0.0,50.128098,50.128098,18.465099,7.60769,18348.84975,31224.26195,12875.412190000001,24762.93588,2979.575359,10967.47272,21542.43384,10574.96112,17411.275169999997,2668.910746,18338.912780000002,29105.567989999996,10766.655209999999,24059.855330000002,2277.45532,18474.33659,27823.27637,9348.939784999999,23457.94349,1924.120155,2.0,1.0,0.0,2.0,0.0,2.0,1,0,0,1,1,0,0,0,0,2,0,0,0,1,0,4.0,4.0,4.0,3.0,1.0,5.0,6,3,2,5,5,3,2,1,6,3,4,4,3,0,4,-2,-3,-4,-1,-1,-3,-5,-3,-2,-4,-4,-3,-2,-1,-6,-1,-4,-4,-3,1,-4,2.954209749,1.552795031,0,3.120124805,0,3.231017771,1.652892562,0.0,0.0,1.8315018319999998,1.8148820330000002,0.0,0.0,0.0,0.0,4.201680672,0.0,0.0,0.0,2.314814815,4.77326969,5.908419498,6.211180124,6.182380216,4.680187207,1.602564103,8.077544426,9.917355372000001,5.050505051,3.533568905,9.157509158,9.074410163,5.405405405,3.7243947860000004,2.024291498,12.5,6.302521007999999,8.492569002,8.791208791,6.756756757000001,0.0,9.546539379,-2.954209749,-4.658385093,-6.182380216,-1.560062402,-1.602564103,-4.846526656,-8.26446281,-5.050505051,-3.533568905,-7.326007326,-7.259528131000001,-5.405405405,-3.7243947860000004,-2.024291498,-12.5,-2.100840336,-8.492569002,-8.791208791,-6.756756757000001,2.314814815,-9.546539379,2,1,1,18,18,0,-16,-17,1,15,6,9,15,15,0,0,-9,9,16,16,0,6,6,0,10,10,0,4,3,1,6,6,0,-2,-3,1,9,7,2,6,4,2,3,3,0,10,10,0,9,9,0,1,1,0,4,3,1,9,9,0,-5,-6,1,3,3,0,14,14,0,-11,-11,0,3,3,0,8,8,0,-5,-5,0,3.0,3.0,4.0,5.0,2.0,3.0,5.0,3.0,11.0,5.0,6.0,5.0,10.0,10.0,2.0,12.0,6.0,8.0,7.0,16.0,18.0,7.0,10.0,23.0,6.0,24.0,34.0,17.0,28.0,20.0,21.0,28.0,14.0,25.0,11.0,14.0,29.0,21.0,15.0,13.0,13.0,21.0,14.0,11.0,28.0,16.0,24.0,21.0,6.0,13.0,18.0,5.0,13.0,4.0,4.0,4.0,2.0,5.0,1.0,2.0,0.0,0.0,0.0,1.0,0.0,4.0,1.0,2.0,2.0,1.0,1.0,7.0,3.0,4.0,2.0,7.0,6.0,2.0,9.0,5.0,4.0,5.0,9.0,12.0,5.0,9.0,16.0,3.0,16.0,27.0,11.0,21.0,15.0,15.0,21.0,13.0,17.0,11.0,9.0,19.0,15.0,7.0,12.0,7.0,12.0,11.0,7.0,15.0,10.0,12.0,13.0,2.0,7.0,11.0,2.0,4.0,1.0,1.0,3.0,0.0,1.0,0.0,0.0,0.0,0.0,0.0,2.0,3.0,0.0,4.0,0.0,1.0,4.0,2.0,4.0,2.0,2.0,3.0,3.0,4.0,0.0,3.0,1.0,4.0,2.0,7.0,6.0,2.0,1.0,7.0,3.0,8.0,7.0,6.0,7.0,5.0,6.0,7.0,1.0,8.0,0.0,5.0,10.0,6.0,8.0,1.0,6.0,9.0,3.0,4.0,13.0,6.0,12.0,8.0,4.0,6.0,7.0,3.0,9.0,3.0,3.0,1.0,2.0,4.0,1.0,2.0,0.0,0.0,0.0,6.741573034,3.238866397,6.046511627999999,44,5,39,5,24,10,52,13,39,3,24,3,8,13,96,79,63,35.95505618,31.98380567,29.30232558,181.05263159999998,183.90804599999998,172.1518987,153,160,139,57.30337079,64.77732794,64.65116279,80.74509804,57.375,58.32374101,62.74509804,49.375,45.32374101,533.3333333,987.5,484.61538459999997,87,32.58426966,31.57894737,78,17.20930233,37,300.0,350.0,580.0,66.31578947,63,6.349206349,82.75862069,72,4.166666667,40.50632911,32,9.375,0.0,4.166666667,6.25,40829.683,89545586.11,215.0,221.0,232.0,238.0,239.0,237.0,241.0,236.0,225.0,252.0,265.0,247.0,252.0,272.0,263.0,251.0,257.0,285.0,267.0,276.0,288.0,294.0,292.0,291.0,296.5,302.0,258.0,423.0,689.0,994.0,1164.0,1199.0,1279.0,1245.0,1270.0,1140.0,89.54558563,12.73094583,14.18272035,13.90353295,14.28322782,13.38982811,12.99896574,11.10049136,7.69440498,4.723850953,2.881214056,3.372583895,3.311162665,3.2497414360000003,3.260908932,3.283243925,3.216238947,3.08222899,2.981721523,3.182736457,2.87004656,2.803041582,2.937051538,3.037559005,2.814209078,2.7583715960000004,2.9593865310000003,2.814209078,2.512686677,2.635529137,2.691366618,2.646696633,2.6690316259999998,2.657864129,2.590859151,2.468016692,2.401011714,0,0,0,0,1,40814.25472,8457.106359000001,14513.43718,9441.036984999999,4711.367048,10,45,0.018005471999999998,0,0.0,0.0,1.0,1.0
39054,2436,Cantabria,Cantabria,Polanco,-2,218,220,53.361198,43.79208,0.0,22.586257999999997,22.586257999999997,5.946606,4.408092,1749.9662629999998,7166.587470999999,5416.621208,4548.721402,1285.493929,2.92748,3384.211273,3381.283793,1601.104432,820.633786,8.823144000000001,3301.6955239999998,3292.8723800000002,1409.947871,795.915276,50.166416,3695.5434939999996,3645.377079,1705.192436,843.610295,29.0,25.0,38.0,32.0,38.0,30.0,44,62,63,72,75,77,75,68,60,70,62,59,50,50,51,33.0,34.0,38.0,39.0,29.0,38.0,49,47,35,45,48,47,39,37,43,41,39,43,45,32,50,-4,-9,0,-7,9,-8,-5,15,28,27,27,30,36,31,17,29,23,16,5,18,1,91.19496855,79.36507937,119.873817,105.9602649,128.8135593,97.08737864,137.9310345,191.3580247,195.6521739,227.1293375,241.9354839,250.0,247.52475249999998,240.28268549999999,218.9781022,268.1992337,243.13725490000002,231.37254900000002,197.6284585,209.2050209,123.4042553,103.7735849,107.9365079,119.873817,129.1390728,98.30508475,122.9773463,153.6050157,145.0617284,108.69565220000001,141.955836,154.83870969999998,152.59740259999998,128.7128713,130.7420495,156.93430659999999,157.0881226,152.94117649999998,168.627451,177.8656126,133.8912134,212.7659574,-12.57861635,-28.57142857,0,-23.17880795,30.50847458,-25.88996764,-15.67398119,46.2962963,86.95652174,85.17350158,87.09677419,97.4025974,118.81188119999999,109.540636,62.04379562,111.1111111,90.19607843,62.74509804,19.76284585,75.31380753,4.255319149,301,288,13,238,229,9,63,59,4,282,277,5,255,245,10,27,32,-5,327,316,11,272,237,35,55,79,-24,301,290,11,245,239,6,56,51,5,295,283,12,250,240,10,45,43,2,271,248,23,293,278,15,-22,-30,8,361,333,28,305,296,9,56,37,19,320,286,34,288,281,7,32,5,27,306,291,15,269,258,11,37,33,4,280.0,349.0,140.0,350.0,253.0,101.0,400.0,184.0,159.0,284.0,173.0,208.0,198.0,244.0,287.0,232.0,396.0,315.0,325.0,590.0,280.0,509.0,497.0,286.0,709.0,407.0,323.0,556.0,367.0,277.0,425.0,343.0,219.0,374.0,276.0,229.0,349.0,218.0,161.0,311.0,203.0,213.0,223.0,141.0,204.0,167.0,190.0,166.0,107.0,124.0,116.0,113.0,79.0,59.0,48.0,20.0,23.0,14.0,8.0,3.0,4.0,3.0,0.0,132.0,192.0,67.0,184.0,123.0,66.0,216.0,101.0,87.0,140.0,99.0,117.0,102.0,131.0,139.0,121.0,204.0,157.0,155.0,287.0,143.0,254.0,251.0,149.0,354.0,216.0,153.0,286.0,188.0,139.0,219.0,172.0,117.0,192.0,145.0,97.0,184.0,102.0,88.0,157.0,97.0,94.0,105.0,65.0,92.0,65.0,76.0,68.0,41.0,45.0,48.0,40.0,30.0,18.0,7.0,4.0,5.0,3.0,2.0,0.0,1.0,0.0,0.0,148.0,157.0,73.0,166.0,130.0,35.0,184.0,83.0,72.0,144.0,74.0,91.0,96.0,113.0,148.0,111.0,192.0,158.0,170.0,303.0,137.0,255.0,246.0,137.0,355.0,191.0,170.0,270.0,179.0,138.0,206.0,171.0,102.0,182.0,131.0,132.0,165.0,116.0,73.0,154.0,106.0,119.0,118.0,76.0,112.0,102.0,114.0,98.0,66.0,79.0,68.0,73.0,49.0,41.0,41.0,16.0,18.0,11.0,6.0,3.0,3.0,3.0,0.0,10.61289467,15.51826259,17.22984276,459,180,449,370,568,498,325,220,449,416,568,532,786,1030,784,768,987,20.80127355,15.16288253,16.51053864,95.79220779,99.80276134,97.94701987,2585,3511,3961,68.58583179,69.31885489,66.2596186,430.32882010000003,807.8741098999999,1054.91795,30.32882012,21.87410994,24.91795001,196.0,97.70992366,95.82524272,352,9.339347307,36.74234946,1861,35.11207762,2099,77.40384615,126.0115607,122.88732390000001,44.57142857,858,16.31701632,91.00591716,2307,15.12787169,37.28476821,1126,24.86678508,8.508158508,6.805374946000001,13.14387211,17609.281430000003,17555264.72,5978.0,5942.0,5896.0,5845.0,5850.0,5794.0,5705.0,5633.0,5585.0,5486.0,5283.0,5065.0,4764.0,4515.0,4224.0,3993.0,3910.0,3857.0,3769.0,3700.0,3622.0,3574.0,3586.0,3631.0,3645.5,3660.0,3806.0,4082.0,3531.0,3659.0,3059.0,2665.0,2655.0,2123.0,1226.0,1072.0,17.55526543,61.06430031,69.83659718,120.93237830000001,151.23667659999998,151.80630630000002,174.24971519999997,208.42749519999998,201.1362354,232.5228301,216.80105130000004,208.4844581,207.65849509999998,206.8325321,204.2691986,203.585643,206.3198654,210.76297680000002,214.69342149999997,219.70616260000003,222.7251998,227.4531261,240.6115714,257.1877947,271.3715734,288.5174264,300.93535310000004,312.4988353,318.138169,320.8723915,324.9737251,330.0434291,333.23335519999995,332.94854039999996,335.8536517,338.4739482,340.524615,0,1,0,1,1,5819.713051,10275.31305,2805.935806,2517.928983,2226.570647,17,76,0.009966274,0,1.0,1.0,1.0,1.0
39055,2437,Cantabria,Cantabria,Potes,278,845,567,496.166667,132.51608000000002,0.6129,39.144512,38.531612,19.655604999999998,7.610075999999999,41015.882410000006,44158.70908,3142.826663,42842.93219,734.324391,32.594186,2022.6722989999998,1990.0781129999998,1003.25419,377.780027,24225.097690000002,28627.05065,4401.952961999999,26531.80996,1106.129977,24107.87577,28447.67905,4339.803278,26401.8654,1103.780466,15.0,9.0,15.0,17.0,13.0,9.0,8,13,15,9,9,9,11,10,12,8,10,11,9,3,9,26.0,11.0,25.0,35.0,15.0,16.0,20,15,14,12,21,17,12,17,18,18,23,13,17,20,28,-11,-2,-10,-18,-2,-7,-12,-2,1,-3,-12,-8,-1,-7,-6,-10,-13,-2,-8,-17,-19,118.1102362,69.76744186,120.9677419,139.3442623,112.0689655,79.6460177,71.42857143,122.6415094,150.0,90.90909091,102.2727273,109.7560976,120.8791209,109.89010990000001,126.31578950000001,79.20792079,123.45679009999998,135.8024691,120.0,37.03703704,205.4794521,204.7244094,85.27131783,201.6129032,286.8852459,129.3103448,141.5929204,178.5714286,141.509434,140.0,121.21212120000001,238.63636359999998,207.31707319999998,131.8681319,186.8131868,189.4736842,178.21782180000002,239.58333330000002,160.4938272,226.66666669999998,246.91358019999996,383.5616438,-86.61417323,-15.50387597,-80.64516129,-147.5409836,-17.24137931,-61.94690265,-107.1428571,-18.86792453,10.0,-30.303030300000003,-136.36363640000002,-97.56097561,-10.98901099,-76.92307692,-63.15789474,-99.00990099,-135.41666669999998,-24.69135802,-106.66666670000001,-209.87654320000001,-260.2739726,75,70,5,87,78,9,-12,-8,-4,97,86,11,120,96,24,-23,-10,-13,95,86,9,99,88,11,-4,-2,-2,61,54,7,95,83,12,-34,-29,-5,122,106,16,119,106,13,3,0,3,106,85,21,85,81,4,21,4,17,123,97,26,107,104,3,16,-7,23,113,93,20,112,86,26,1,7,-6,106,91,15,93,80,13,13,11,2,40.0,51.0,60.0,45.0,54.0,83.0,55.0,63.0,77.0,50.0,72.0,82.0,49.0,88.0,104.0,59.0,115.0,144.0,91.0,133.0,145.0,85.0,137.0,121.0,90.0,130.0,130.0,123.0,94.0,79.0,112.0,95.0,80.0,93.0,69.0,83.0,88.0,87.0,77.0,71.0,71.0,80.0,65.0,71.0,76.0,54.0,67.0,62.0,65.0,59.0,43.0,44.0,29.0,40.0,32.0,21.0,20.0,10.0,4.0,10.0,1.0,1.0,1.0,17.0,33.0,28.0,21.0,29.0,38.0,31.0,30.0,42.0,29.0,42.0,51.0,26.0,55.0,57.0,32.0,70.0,81.0,49.0,73.0,68.0,42.0,50.0,57.0,51.0,63.0,67.0,52.0,51.0,39.0,52.0,45.0,37.0,38.0,36.0,38.0,49.0,40.0,41.0,33.0,34.0,40.0,29.0,37.0,35.0,19.0,25.0,26.0,27.0,23.0,10.0,12.0,10.0,16.0,14.0,4.0,2.0,5.0,1.0,1.0,0.0,0.0,0.0,23.0,18.0,32.0,24.0,25.0,45.0,24.0,33.0,35.0,21.0,30.0,31.0,23.0,33.0,47.0,27.0,45.0,63.0,42.0,60.0,77.0,43.0,87.0,64.0,39.0,67.0,63.0,71.0,43.0,40.0,60.0,50.0,43.0,55.0,33.0,45.0,39.0,47.0,36.0,38.0,37.0,40.0,36.0,34.0,41.0,35.0,42.0,36.0,38.0,36.0,33.0,32.0,19.0,24.0,18.0,17.0,18.0,5.0,3.0,9.0,1.0,1.0,1.0,13.77582968,11.11846459,10.59001513,202,112,189,76,203,71,130,108,189,92,203,69,168,140,332,323,342,20.78897934,21.37657181,25.869894100000003,94.04617254,98.81578947,90.48991354,1045,1020,840,65.43519098,67.5049636,63.54009077,251.7703349,199.66666669999998,180.71428569999998,31.77033493,31.66666667,40.71428571,150.9090909,192.26190480000002,244.28571430000002,968,60.61365059,32.69358041,494,29.42511346,389,93.90243902,120.83333329999999,176.0,46.29404617,381,15.7480315,88.81578947,675,7.555555556,32.99711816,229,17.46724891,8.398950131,2.666666667,10.04366812,13714.738309999999,7676278.961,1322.0,1332.0,1343.0,1350.0,1342.0,1360.0,1413.0,1421.0,1452.0,1474.0,1481.0,1511.0,1533.0,1511.0,1500.0,1499.0,1584.0,1588.0,1597.0,1590.0,1580.0,1573.0,1564.0,1579.0,1600.5,1622.0,1411.0,1444.0,1206.0,1364.0,1434.0,1239.0,1208.0,1139.0,1336.0,1241.0,7.6762790679999995,161.66686869999998,174.0426564,148.37918080000003,157.3679108,161.40632580000002,186.8092584,177.6902569,157.1073679,188.1119729,183.81301509999997,211.3002909,208.49945469999997,205.6986186,203.74454680000002,204.9169899,205.82889,207.13160449999998,208.04350469999997,206.8710616,206.3499758,195.27690259999997,195.4071741,196.84016,199.7061319,196.84016,192.9320165,192.0201164,189.1541445,185.11572959999998,184.07355800000002,177.1691712,174.8242851,175.8664567,174.9545565,173.5215706,172.2188561,0,1,6,1,1,50214.364689999995,8839.820181000001,1189.079399,1239.529622,1235.658666,51,205,0.06139933,0,0.82,0.14,1.0,1.0
39057,2438,Cantabria,Cantabria,Ramales de la Victoria,48,797,749,271.90607,166.795525,0.0,57.062408,57.062408,16.329753,9.547071,13739.928259999999,19590.84994,5850.9216799999995,16611.96655,1359.836963,15.521663,4886.849329,4871.327665,1775.798738,1046.108326,11141.286259999999,17478.137580000002,6336.851315,14155.958630000001,1361.555643,36.726434999999995,6245.26147,6208.535035,2981.171234,1211.618094,12.0,13.0,14.0,17.0,16.0,12.0,22,24,17,33,21,21,28,21,27,19,18,19,20,21,22,22.0,31.0,19.0,25.0,29.0,29.0,33,30,22,31,30,36,32,35,35,34,24,29,37,24,42,-10,-18,-5,-8,-13,-17,-11,-6,-5,2,-9,-15,-4,-14,-8,-15,-6,-10,-17,-3,-20,20.44293015,22.45250432,25.17985612,30.19538188,28.52049911,22.47191011,41.35338346,45.11278195,32.81853282,66.80161943,43.65904366,44.7761194,62.22222222,48.8372093,64.28571429,45.02369668,44.7761194,47.26368159,50.25125628,54.6875,32.34501348,37.47870528,53.54058722,34.17266187,44.40497336,51.69340463,54.3071161,62.03007519,56.39097744,42.47104247,62.75303644,62.37006237,76.75906183,71.11111111,81.39534884,83.33333333,80.56872038,57.41626794,72.13930348,92.96482412,62.5,113.20754720000001,-17.03577513,-31.0880829,-8.992805755,-14.20959147,-23.17290553,-31.83520599,-20.67669173,-11.27819549,-9.652509653,4.048582996,-18.71101871,-31.98294243,-8.888888889,-32.55813953,-19.04761905,-35.5450237,-14.35406699,-24.87562189,-42.71356784,-7.8125,-53.908355799999995,151,140,11,135,131,4,16,9,7,141,138,3,113,98,15,28,40,-12,191,181,10,185,161,24,6,20,-14,170,151,19,145,143,2,25,8,17,221,205,16,137,135,2,84,70,14,200,191,9,173,167,6,27,24,3,171,156,15,162,156,6,9,0,9,188,160,28,170,163,7,18,-3,21,184,177,7,130,127,3,54,50,4,99.0,123.0,65.0,120.0,85.0,65.0,138.0,83.0,95.0,96.0,101.0,103.0,103.0,132.0,168.0,125.0,210.0,159.0,164.0,236.0,161.0,214.0,191.0,148.0,277.0,199.0,163.0,227.0,196.0,171.0,221.0,193.0,125.0,216.0,152.0,136.0,223.0,148.0,130.0,173.0,140.0,134.0,144.0,135.0,148.0,136.0,134.0,105.0,107.0,108.0,91.0,79.0,53.0,55.0,32.0,23.0,14.0,8.0,8.0,3.0,0.0,0.0,3.0,55.0,64.0,36.0,64.0,40.0,34.0,72.0,45.0,54.0,40.0,57.0,61.0,55.0,70.0,83.0,67.0,117.0,86.0,72.0,118.0,101.0,110.0,104.0,76.0,145.0,98.0,81.0,131.0,116.0,90.0,110.0,101.0,64.0,123.0,82.0,70.0,119.0,70.0,67.0,86.0,79.0,70.0,64.0,65.0,69.0,68.0,61.0,53.0,39.0,47.0,29.0,34.0,18.0,16.0,11.0,7.0,4.0,1.0,2.0,0.0,0.0,0.0,1.0,44.0,59.0,29.0,56.0,45.0,31.0,66.0,38.0,41.0,56.0,44.0,42.0,48.0,62.0,85.0,58.0,93.0,73.0,92.0,118.0,60.0,104.0,87.0,72.0,132.0,101.0,82.0,96.0,80.0,81.0,111.0,92.0,61.0,93.0,70.0,66.0,104.0,78.0,63.0,87.0,61.0,64.0,80.0,70.0,79.0,68.0,73.0,52.0,68.0,61.0,62.0,45.0,35.0,39.0,21.0,16.0,10.0,7.0,6.0,3.0,0.0,0.0,2.0,10.03568243,10.98113208,12.30186079,311,101,322,142,376,166,242,124,322,149,376,191,291,357,553,601,679,24.66547725,22.67924528,23.39765679,104.3755697,105.5857254,102.0891365,1464,1758,1866,65.29884032,66.33962264,64.30048243,262.773224,325.1865757,393.3879957,37.77322404,34.18657565,36.38799571,245.7777778,206.5292096,190.1960784,567,25.28991971,31.01886792,822,30.39283253,882,126.21359220000001,146.5346535,232.29166669999998,44.48495898,488,13.31967213,82.93250582,1069,11.50608045,34.05292479,489,20.24539877,5.942622951000001,5.519176801,8.99795501,27268.23737,32036356.46,2902.0,2877.0,2876.0,2881.0,2895.0,2827.0,2820.0,2820.0,2805.0,2788.0,2784.0,2650.0,2575.0,2489.0,2367.0,2333.0,2312.0,2273.0,2242.0,2231.0,2242.0,2228.0,2253.0,2239.0,2261.5,2284.0,2481.0,2439.0,2219.0,2468.0,2645.0,2532.0,2498.0,2377.0,2338.0,2051.0,32.03635788,64.02101037,72.97958179,74.19694863,77.97390731,79.03520149,82.56244389,77.03747128,69.26505217,76.13224978,77.44326023,71.29399692,70.59166989,69.88934287,70.32634635,69.54598299,69.98298647,69.63962659,69.98298647,70.95063704,72.16800389,72.82350911,73.88480329,77.6929765,80.37742648,82.71851657,86.9012642,87.02612233,87.55676942,88.02498744,88.02498744,88.24348918,90.36607753,89.92907405,89.77300138,89.80421591,90.58457927,0,1,2,1,1,16796.3792,2277.246721,2732.364906,2663.389821,2621.424361,37,190,0.0027849579999999997,0,0.95,0.11,1.0,1.0
39060,2439,Cantabria,Cantabria,Reoc√≠n,-70,306,376,122.20034,63.423443999999996,0.0,40.995715999999994,40.995715999999994,7.292199,5.057279,2581.068049,10546.31182,7965.243767,6373.547002,1951.506055,2.874789,3417.815093,3414.9403039999997,1214.383873,713.736122,21.682585999999997,4365.431044,4343.748458,1715.9279649999999,837.4696769999999,6.114006,3808.698185,3802.584178,1381.835143,727.572785,55.0,73.0,72.0,76.0,75.0,92.0,91,105,106,90,104,90,86,92,65,64,70,77,58,50,43,68.0,44.0,55.0,65.0,65.0,58.0,62,64,74,79,68,84,76,67,79,88,73,66,87,64,65,-13,29,17,11,10,34,29,41,32,11,36,6,10,25,-14,-24,-3,11,-29,-14,-22,143.9790576,193.1216931,194.0700809,202.6666667,206.043956,252.7472527,257.0621469,305.2325581,308.1395349,268.6567164,306.7846608,265.48672569999997,262.9969419,288.4012539,209.67741940000002,214.0468227,234.1137124,257.5250836,207.1428571,182.4817518,203.70370369999998,178.0104712,116.4021164,148.2479784,173.3333333,178.5714286,159.3406593,175.1412429,186.0465116,215.11627909999999,235.8208955,200.58997050000002,247.78761060000002,232.41590209999998,210.031348,254.8387097,294.31438130000004,252.5951557,220.735786,310.7142857,233.5766423,240.74074069999998,-34.03141361,76.71957672,45.82210243,29.33333333,27.47252747,93.40659341,81.92090395,119.1860465,93.02325581,32.835820899999995,106.19469029999999,17.69911504,30.58103976,78.36990596,-45.16129032,-80.26755853,-10.38062284,36.78929766,-103.57142859999999,-51.09489051,-81.48148148,295,275,20,285,279,6,10,-4,14,253,241,12,274,265,9,-21,-24,3,318,306,12,256,251,5,62,55,7,273,253,20,315,292,23,-42,-39,-3,308,281,27,292,276,16,16,5,11,333,305,28,268,254,14,65,51,14,359,316,43,335,324,11,24,-8,32,349,298,51,316,309,7,33,-11,44,354,334,20,337,323,14,17,11,6,270.0,470.0,303.0,424.0,409.0,301.0,504.0,329.0,381.0,457.0,385.0,428.0,349.0,438.0,553.0,361.0,557.0,557.0,431.0,809.0,546.0,582.0,715.0,589.0,830.0,625.0,594.0,739.0,645.0,565.0,631.0,616.0,437.0,649.0,494.0,337.0,583.0,365.0,253.0,496.0,279.0,366.0,341.0,294.0,396.0,251.0,326.0,272.0,200.0,261.0,146.0,193.0,121.0,82.0,74.0,42.0,38.0,14.0,13.0,11.0,3.0,1.0,2.0,149.0,260.0,156.0,204.0,200.0,160.0,275.0,174.0,201.0,236.0,215.0,225.0,187.0,223.0,295.0,185.0,271.0,295.0,209.0,409.0,253.0,289.0,361.0,283.0,413.0,299.0,305.0,391.0,318.0,285.0,294.0,317.0,244.0,311.0,259.0,158.0,299.0,169.0,128.0,233.0,141.0,167.0,172.0,131.0,186.0,105.0,150.0,118.0,83.0,100.0,51.0,74.0,42.0,28.0,22.0,13.0,10.0,5.0,2.0,1.0,1.0,0.0,1.0,121.0,210.0,147.0,220.0,209.0,141.0,229.0,155.0,180.0,221.0,170.0,203.0,162.0,215.0,258.0,176.0,286.0,262.0,222.0,400.0,293.0,293.0,354.0,306.0,417.0,326.0,289.0,348.0,327.0,280.0,337.0,299.0,193.0,338.0,235.0,179.0,284.0,196.0,125.0,263.0,138.0,199.0,169.0,163.0,210.0,146.0,176.0,154.0,117.0,161.0,95.0,119.0,79.0,54.0,52.0,29.0,28.0,9.0,11.0,10.0,2.0,1.0,1.0,13.76274976,14.74249451,14.29253162,751,468,758,574,877,570,562,517,758,634,877,628,1208,1198,1313,1337,1572,18.34567556,16.31681718,18.75447387,98.41973940000001,97.92270531,97.45583039,4859,5649,5612,67.89157468,68.94068831,66.95299451,1012.0220210000001,1231.6679060000001,1226.0114039999999,27.02202099,23.66790582,28.01140413,133.29949240000002,110.67880790000001,131.2186978,1037,14.48931116,34.09812058,2794,30.80410403,2582,59.11214953,94.80519481,127.57111599999999,45.91072914,1656,18.29710145,85.24154589,3529,13.31822046,35.78327444,1519,17.77485188,8.876811594,5.950694248,7.965766952,29223.364380000003,32095696.18,8382.0,8399.0,8384.0,8381.0,8312.0,8318.0,8382.0,8328.0,8350.0,8318.0,8287.0,8194.0,8196.0,8120.0,7959.0,7702.0,7434.0,7191.0,7157.0,7022.0,6938.0,6900.0,6867.0,6843.0,6840.0,6837.0,6490.0,6956.0,6836.0,6813.0,5112.0,4607.0,4139.0,3358.0,3068.0,2751.0,32.095695500000005,85.71242833,95.58914218,104.6246217,128.9581028,143.53949740000002,159.2736945,212.2714556,212.9880626,216.72688169999998,202.2078008,213.01921940000003,213.11268990000002,213.20616030000002,213.95392420000002,214.98209939999998,216.1660588,218.78323219999996,222.9894037,224.0487358,231.61984449999997,239.9698739,247.97717819999997,252.99342709999996,255.36134590000003,255.29903230000002,258.1966171,259.1624787,260.1594971,259.47404700000004,261.1565156,259.1624787,258.97553769999996,261.1253587,261.2188292,261.6861816,261.1565156,0,0,8,1,1,4386.609967,8451.391296,3027.59013,3356.4923759999997,2352.1462309999997,26,173,6.80793e-05,0,1.0,0.0,1.0,1.0
39058,2440,Cantabria,Cantabria,Rasines,14,708,694,281.904442,172.71541200000001,0.17336,38.761547,38.588187,13.574138,6.872072999999999,8783.135626000001,16427.179930000002,7644.044304000001,12781.162540000001,1795.009816,15.655126000000001,7635.358906999999,7619.703781,2732.8910739999997,1888.402916,6762.363415999999,13461.386369999998,6699.022953,10064.03313,1478.523442,40.109265,7000.001942,6959.892677,3318.9076670000004,1554.2102630000002,1.0,2.0,7.0,6.0,2.0,4.0,8,4,9,5,9,8,4,6,9,1,2,4,4,3,7,18.0,14.0,21.0,16.0,19.0,12.0,10,13,15,8,13,11,24,19,14,15,14,16,17,10,13,-17,-12,-14,-10,-17,-8,-2,-9,-6,-3,-4,-3,-20,-13,-5,-14,-12,-12,-13,-7,-6,3.144654088,6.430868167,24.05498282,22.1402214,7.692307692,16.87763713,34.93449782,17.46724891,40.54054054,23.92344498,44.55445545,39.408867,20.10050251,31.57894737,49.45054945,5.747126437,12.19512195,24.390243899999998,25.3164557,17.75147929,5.882352941000001,56.60377358,45.01607717,72.16494845,59.04059041,73.07692308,50.63291139,43.66812227,56.76855895,67.56756757,38.27751196,64.35643564,54.18719212,120.60301509999998,100.0,76.92307692,86.20689655,82.84023669,97.56097561,107.5949367,59.17159763,76.47058824,-53.4591195,-38.585209,-48.10996564,-36.900369,-65.38461538,-33.75527426,-8.733624454,-39.30131004,-27.02702703,-14.35406699,-19.8019802,-14.77832512,-100.50251259999999,-68.42105263,-27.47252747,-80.45977011,-71.00591716,-73.17073171,-82.27848101,-41.42011834,-35.29411765,69,64,5,59,55,4,10,9,1,48,47,1,61,55,6,-13,-8,-5,54,49,5,44,34,10,10,15,-5,36,34,2,53,53,0,-17,-19,2,47,46,1,29,23,6,18,23,-5,45,40,5,51,50,1,-6,-10,4,42,38,4,46,45,1,-4,-7,3,78,63,15,49,48,1,29,15,14,67,60,7,39,38,1,28,22,6,22.0,36.0,15.0,28.0,36.0,31.0,48.0,34.0,24.0,36.0,31.0,39.0,45.0,43.0,63.0,52.0,68.0,54.0,37.0,94.0,67.0,44.0,89.0,60.0,79.0,88.0,55.0,100.0,61.0,67.0,81.0,84.0,70.0,70.0,69.0,74.0,81.0,75.0,53.0,58.0,56.0,55.0,74.0,51.0,52.0,43.0,42.0,64.0,34.0,46.0,53.0,26.0,35.0,35.0,8.0,18.0,9.0,3.0,2.0,3.0,2.0,0.0,0.0,10.0,20.0,6.0,10.0,16.0,12.0,22.0,17.0,9.0,16.0,17.0,19.0,21.0,22.0,34.0,29.0,39.0,30.0,20.0,60.0,44.0,25.0,51.0,32.0,40.0,52.0,30.0,55.0,30.0,41.0,45.0,51.0,46.0,38.0,42.0,34.0,44.0,40.0,38.0,30.0,35.0,31.0,41.0,29.0,25.0,21.0,17.0,30.0,17.0,23.0,18.0,7.0,14.0,14.0,4.0,2.0,3.0,0.0,1.0,1.0,0.0,0.0,0.0,12.0,16.0,9.0,18.0,20.0,19.0,26.0,17.0,15.0,20.0,14.0,20.0,24.0,21.0,29.0,23.0,29.0,24.0,17.0,34.0,23.0,19.0,38.0,28.0,39.0,36.0,25.0,45.0,31.0,26.0,36.0,33.0,24.0,32.0,27.0,40.0,37.0,35.0,15.0,28.0,21.0,24.0,33.0,22.0,27.0,22.0,25.0,34.0,17.0,23.0,35.0,19.0,21.0,21.0,4.0,16.0,6.0,3.0,1.0,2.0,2.0,0.0,0.0,7.423117709,10.01890359,10.09268795,149,43,129,53,128,56,122,27,129,53,128,42,106,98,271,250,248,28.73806999,23.6294896,25.54067971,111.43497759999998,120.41666670000001,103.9915966,602,702,625,63.8388123,66.35160681,64.36663234,115.0166113,141.6125356,137.68,45.016611299999994,35.61253561,39.68,387.14285710000007,235.8490566,253.0612245,1796,190.4559915,31.37996219,332,26.77651905,260,135.8974359,241.9354839,225.0,42.37668161,189,7.936507937000001,86.04166667,413,8.716707022000001,31.72268908,151,14.56953642,4.7619047619999995,3.87409201,7.947019868,35370.99694,43695161.26,971.0,955.0,931.0,952.0,966.0,959.0,990.0,988.0,1011.0,1023.0,1024.0,1058.0,1055.0,1063.0,1045.0,999.0,968.0,944.0,943.0,947.0,946.0,963.0,960.0,983.0,999.5,1016.0,1030.0,1109.0,1176.0,1504.0,1617.0,1715.0,1661.0,1739.0,1630.0,1497.0,43.69515991,34.26008746,37.30390284,39.79845831,38.01336357,39.24919839,37.00638705,34.42028827,26.91373604,25.38038543,23.57240486,23.25200324,22.87438705,22.49677085,21.97039677,22.03905426,21.64999515,21.67288098,21.58133766,21.60422349,22.15348341,22.86294413,23.91569231,24.32763725,24.14455061,24.2132081,23.43508988,23.41220405,23.13757409,22.6112,22.65697166,21.94751094,22.10771175,21.78731013,21.3067077,21.85596762,22.2221409,0,0,0,0,1,13426.83278,4412.5198359999995,6967.645418000001,5298.1939729999995,3539.8218810000003,8,60,0.002440225,0,0.0,0.0,1.0,1.0
39059,2441,Cantabria,Cantabria,Reinosa,837,907,70,856.2240800000001,10.368299,0.0,9.966614,9.966614,1.947525,1.586501,41.576798,1786.908309,1745.3315100000002,881.2736859999999,404.768842,151.352113,2218.6278230000003,2067.2757100000003,1335.35206,526.6964780000001,61.068417000000004,1854.155625,1793.087208,970.081509,445.43970599999994,44.194268,2456.505212,2412.3109440000003,995.939501,561.864758,61.0,58.0,79.0,80.0,75.0,74.0,74,66,76,71,63,68,63,65,77,51,59,57,58,51,51,148.0,97.0,137.0,112.0,107.0,128.0,134,147,123,142,112,156,139,154,150,151,169,162,153,142,177,-87,-39,-58,-32,-32,-54,-60,-81,-47,-71,-49,-88,-76,-89,-73,-100,-110,-105,-95,-91,-126,109.5152603,105.0724638,147.9400749,156.555773,152.4390244,153.2091097,155.1362683,143.7908497,167.4008811,158.83668899999998,148.23529409999998,158.13953490000003,149.28909950000002,169.7127937,213.88888889999998,151.33531159999998,190.32258059999998,183.8709677,179.0123457,153.1531532,180.47337280000002,265.7091562,175.7246377,256.5543071,219.1780822,217.4796748,265.010352,280.9224319,320.2614379,270.92511010000004,317.67337810000004,263.52941180000005,362.7906977,329.3838863,402.0887728,416.6666667,448.0712166,524.8447205,522.5806451999999,472.22222220000003,426.42642639999997,523.6686391,-156.1938959,-70.65217391,-108.6142322,-62.6223092,-65.04065041,-111.8012422,-125.7861635,-176.4705882,-103.5242291,-158.83668899999998,-115.29411759999999,-204.6511628,-180.0947867,-232.37597909999997,-202.77777780000002,-296.735905,-341.61490679999997,-338.7096774,-293.2098765,-273.2732733,-372.78106510000003,291,260,31,364,343,21,-73,-83,10,309,289,20,307,301,6,2,-12,14,279,260,19,404,358,46,-125,-98,-27,312,287,25,403,307,96,-91,-20,-71,304,267,37,354,303,51,-50,-36,-14,257,228,29,377,343,34,-120,-115,-5,350,300,50,337,326,11,13,-26,39,380,300,80,355,322,33,25,-22,47,328,275,53,346,334,12,-18,-59,41,263.0,364.0,293.0,298.0,334.0,332.0,339.0,352.0,402.0,317.0,437.0,596.0,345.0,484.0,816.0,362.0,656.0,852.0,363.0,736.0,729.0,496.0,680.0,652.0,659.0,657.0,762.0,619.0,679.0,870.0,636.0,845.0,859.0,646.0,764.0,669.0,765.0,756.0,499.0,686.0,531.0,558.0,659.0,449.0,637.0,456.0,602.0,576.0,333.0,498.0,367.0,333.0,314.0,199.0,186.0,101.0,99.0,44.0,35.0,15.0,5.0,3.0,1.0,133.0,172.0,136.0,148.0,168.0,173.0,165.0,186.0,218.0,152.0,238.0,275.0,177.0,241.0,395.0,195.0,320.0,439.0,170.0,373.0,375.0,260.0,349.0,331.0,326.0,335.0,352.0,316.0,323.0,414.0,312.0,382.0,433.0,305.0,392.0,345.0,360.0,371.0,246.0,330.0,256.0,269.0,319.0,195.0,276.0,186.0,259.0,226.0,141.0,167.0,151.0,119.0,105.0,57.0,45.0,22.0,28.0,8.0,10.0,2.0,1.0,0.0,1.0,130.0,192.0,157.0,150.0,166.0,159.0,174.0,166.0,184.0,165.0,199.0,321.0,168.0,243.0,421.0,167.0,336.0,413.0,193.0,363.0,354.0,236.0,331.0,321.0,333.0,322.0,410.0,303.0,356.0,456.0,324.0,463.0,426.0,341.0,372.0,324.0,405.0,385.0,253.0,356.0,275.0,289.0,340.0,254.0,361.0,270.0,343.0,350.0,192.0,331.0,216.0,214.0,209.0,142.0,141.0,79.0,71.0,36.0,25.0,13.0,4.0,3.0,0.0,9.524251136,10.21698939,10.21566402,1442,500,1519,524,1553,454,1010,527,1519,526,1553,446,1050,900,2452,2533,2702,22.73949736,24.6472706,30.66969353,91.1540507,89.85774986,89.78888409999999,7304,6694,5208,67.73625151,65.13574,59.11464245,1060.5706460000001,1087.839857,951.8817204,33.57064622,37.83985659,51.88172043,238.7536514,241.2380952,300.22222220000003,1052,9.756097561,26.77824268,2752,24.25652667,2137,83.72483221,172.9977117,241.3249211,38.41517461,2167,13.52099677,67.43026048,3650,9.97260274,27.57432141,1280,20.546875,7.245039225,5.260273973,10.15625,8669.222807,4097252.223,8810.0,8946.0,9003.0,9095.0,9331.0,9496.0,9605.0,9804.0,9919.0,10071.0,10177.0,10277.0,10307.0,10208.0,10220.0,10370.0,10523.0,10577.0,10783.0,10638.0,10862.0,11193.0,11518.0,11656.0,11721.0,11786.0,12852.0,13172.0,10863.0,10044.0,9450.0,8481.0,8606.0,4180.0,2924.0,2979.0,4.097252369,727.0726164,713.6489864,1020.195883,2100.432003,2069.923753,2306.423708,2451.398912,2651.288967,3214.837363,3136.7362420000004,2876.561886,2860.697596,2844.833305,2811.152197,2731.830747,2651.044901,2596.3741170000003,2631.763687,2581.486091,2568.3065269999997,2530.964428,2494.3545280000003,2491.425736,2515.5882699999997,2508.26629,2483.85969,2457.988694,2420.8906620000002,2392.8230719999997,2344.253938,2317.650744,2277.379854,2219.780277,2197.3262050000003,2183.414443,2150.2214670000003,0,6,10,1,1,40531.38162,11804.24845,716.824294,1091.0100029999999,890.6981529999999,11,45,0.004933448,0,1.0,1.0,1.0,1.0
39061,2442,Cantabria,Cantabria,Ribamont√°n al Mar,-1,189,190,45.903671,43.561509,0.0,28.719134999999998,28.719134999999998,4.479148,4.307399,2268.47586,13519.0394,11250.563540000001,9118.517420999999,2330.890713,4454.118402,9843.837131,5389.718729,7085.8244030000005,1361.485284,4095.248268,10381.79318,6286.544909,7301.339776999999,1372.693547,2185.5463170000003,9717.885435,7532.339118000001,5542.462026,1596.759583,34.0,28.0,36.0,39.0,37.0,43.0,42,28,46,37,45,30,27,40,33,30,25,27,24,26,25,25.0,30.0,21.0,25.0,24.0,37.0,25,21,31,36,31,31,36,43,27,33,25,30,37,45,43,9,-2,15,14,13,6,17,7,15,1,14,-1,-9,-3,6,-3,0,-3,-13,-19,-18,92.39130435,78.43137255,104.9562682,121.1180124,117.4603175,131.4984709,131.661442,87.5,140.2439024,112.4620061,136.36363640000002,92.30769231,82.56880734,122.6993865,101.85185190000001,91.18541033,73.52941176,79.41176471,71.42857143,74.28571429,94.97206704,67.93478261,84.03361345,61.2244898,77.63975155,76.19047619,113.1498471,78.36990596,65.625,94.51219512,109.42249240000001,93.93939394,95.38461538,110.09174309999999,131.9018405,83.33333333,100.3039514,75.52870091,88.23529412,110.1190476,128.5714286,120.1117318,24.45652174,-5.602240896,43.73177843,43.47826087,41.26984127,18.34862385,53.29153605,21.875,45.73170732,3.039513678,42.42424242,-3.076923077,-27.52293578,-9.202453988,18.51851852,-9.118541033,0.0,-8.823529412000001,-38.69047619,-54.28571429,-50.27932961,232,211,21,207,202,5,25,9,16,218,205,13,252,219,33,-34,-14,-20,199,176,23,236,214,22,-37,-38,1,235,209,26,208,188,20,27,21,6,213,181,32,211,167,44,2,14,-12,232,191,41,224,192,32,8,-1,9,237,187,50,237,219,18,0,-32,32,264,185,79,218,192,26,46,-7,53,378,332,46,178,168,10,200,164,36,135.0,231.0,180.0,189.0,199.0,184.0,239.0,204.0,140.0,213.0,181.0,177.0,202.0,184.0,284.0,235.0,284.0,313.0,243.0,393.0,379.0,309.0,375.0,325.0,377.0,395.0,297.0,401.0,333.0,320.0,381.0,364.0,251.0,358.0,305.0,232.0,333.0,241.0,176.0,297.0,210.0,193.0,219.0,174.0,179.0,200.0,180.0,118.0,120.0,116.0,79.0,117.0,58.0,30.0,46.0,15.0,16.0,14.0,8.0,7.0,1.0,0.0,0.0,81.0,123.0,86.0,100.0,86.0,97.0,134.0,105.0,76.0,105.0,88.0,94.0,106.0,96.0,157.0,129.0,145.0,166.0,113.0,209.0,193.0,156.0,199.0,164.0,192.0,210.0,147.0,218.0,166.0,169.0,206.0,191.0,139.0,174.0,166.0,107.0,163.0,120.0,93.0,156.0,100.0,101.0,111.0,95.0,90.0,94.0,88.0,53.0,65.0,50.0,26.0,44.0,20.0,14.0,14.0,2.0,6.0,6.0,1.0,2.0,0.0,0.0,0.0,54.0,108.0,94.0,89.0,113.0,87.0,105.0,99.0,64.0,108.0,93.0,83.0,96.0,88.0,127.0,106.0,139.0,147.0,130.0,184.0,186.0,153.0,176.0,161.0,185.0,185.0,150.0,183.0,167.0,151.0,175.0,173.0,112.0,184.0,139.0,125.0,170.0,121.0,83.0,141.0,110.0,92.0,108.0,79.0,89.0,106.0,92.0,65.0,55.0,66.0,53.0,73.0,38.0,16.0,32.0,13.0,10.0,8.0,7.0,5.0,1.0,0.0,0.0,12.98969072,14.24719101,12.16245409,330,245,405,320,524,248,292,259,405,314,524,315,634,563,622,761,1014,16.03092784,17.1011236,21.90537913,104.2105263,103.196347,104.6419098,2754,3055,3052,70.97938144,68.65168539,65.93216677,526.5853304,658.9099836,596.2241153,22.58533043,24.90998363,33.22411533,123.41269840000001,120.0315457,180.1065719,2463,63.47938144,33.61797753,1496,28.73190754,1330,99.43502825,133.1491713,156.3380282,48.47368421,921,19.54397394,82.73972603,1812,12.74834437,35.41114058,801,16.85393258,10.2062975,5.960264901,6.741573034,37185.75417,37586877.45,4629.0,4478.0,4437.0,4447.0,4426.0,4422.0,4419.0,4462.0,4513.0,4496.0,4476.0,4450.0,4408.0,4310.0,4188.0,4115.0,4045.0,3939.0,3880.0,3826.0,3716.0,3651.0,3525.0,3457.0,3406.0,3355.0,2892.0,2323.0,2188.0,2381.0,2612.0,2515.0,2257.0,1916.0,1575.0,1607.0,37.58687592,42.75428486,41.90292387,50.97523945,60.04755503,66.91165304,69.49234105,63.34657888,58.21180789,61.80348708,76.94174973,89.25987909999999,90.61673568,91.97359227,93.78273438,97.13496829,98.8642953,101.79084870000001,103.2275204,104.7972172,107.61735049999999,109.4797027,111.4218699,114.66768370000001,117.27497679999999,118.3923881,119.0841189,119.6162195,120.068505,118.71164840000002,117.5676321,117.6474472,117.7538673,118.312573,118.0465227,119.13732890000001,123.1546886,0,2,4,0,3,8405.825475,8499.936764,3409.8866299999995,6755.537181000001,1707.606568,167,972,0.005528582,0,1.0,0.04,1.0,1.0
39062,2443,Cantabria,Cantabria,Ribamont√°n al Monte,4,379,375,106.77666299999999,74.325404,0.0,34.270046,34.270046,7.814872,5.286548000000001,7916.092448,15723.846969999999,7807.754522,12575.10908,1800.00438,38.281165,5189.823564,5151.542399,2304.3470199999997,1168.600719,39.478115,5932.902226,5893.424112,2752.2491219999997,1257.923891,14.490758,4675.573668999999,4661.0829109999995,2330.704868,1094.3995869999999,5.0,18.0,19.0,18.0,14.0,19.0,21,7,19,17,17,21,16,19,15,18,13,14,12,10,13,23.0,18.0,16.0,18.0,17.0,18.0,22,26,15,18,28,13,13,17,21,27,30,25,25,33,26,-18,0,3,0,-3,1,-1,-19,4,-1,-11,8,3,2,-6,-9,-17,-11,-13,-23,-13,26.45502646,93.75,104.9723757,107.7844311,83.33333333,120.2531646,140.0,47.94520548,130.1369863,115.6462585,119.71830990000002,141.8918919,111.8881119,143.9393939,116.27906979999999,147.54098359999998,112.0689655,120.68965520000002,104.34782609999999,89.28571429,42.01680672,121.6931217,93.75,88.39779006,107.7844311,101.1904762,113.9240506,146.66666669999998,178.0821918,102.739726,122.44897959999999,197.1830986,87.83783784,90.90909091,128.7878788,162.7906977,221.3114754,245.90163930000003,215.5172414,217.3913043,294.64285710000007,218.48739500000002,-95.23809524,0,16.57458564,0,-17.85714286,6.329113924,-6.666666667,-130.1369863,27.39726027,-6.802721087999999,-77.46478873,54.05405405,20.97902098,15.15151515,-46.51162791,-73.77049179999999,-139.34426230000003,-94.82758621,-113.0434783,-205.3571429,-109.24369750000001,106,95,11,100,100,0,6,-5,11,105,101,4,82,82,0,23,19,4,158,152,6,83,83,0,75,69,6,85,73,12,110,101,9,-25,-28,3,120,114,6,104,96,8,16,18,-2,156,147,9,106,106,0,50,41,9,173,156,17,148,140,8,25,16,9,147,126,21,101,98,3,46,28,18,180,168,12,80,76,4,100,92,8,87.0,91.0,69.0,119.0,88.0,70.0,102.0,87.0,82.0,112.0,77.0,114.0,98.0,108.0,120.0,82.0,130.0,158.0,124.0,160.0,152.0,197.0,179.0,159.0,218.0,175.0,149.0,188.0,164.0,141.0,206.0,163.0,117.0,186.0,134.0,115.0,158.0,124.0,105.0,153.0,123.0,119.0,106.0,95.0,138.0,94.0,114.0,82.0,62.0,73.0,57.0,55.0,37.0,34.0,30.0,14.0,11.0,5.0,6.0,4.0,0.0,0.0,1.0,37.0,56.0,35.0,67.0,36.0,33.0,64.0,45.0,44.0,58.0,38.0,54.0,49.0,54.0,70.0,41.0,73.0,82.0,61.0,90.0,82.0,99.0,100.0,83.0,112.0,92.0,89.0,97.0,89.0,77.0,115.0,86.0,52.0,102.0,65.0,64.0,87.0,68.0,57.0,75.0,59.0,63.0,57.0,49.0,69.0,37.0,57.0,34.0,32.0,31.0,28.0,21.0,13.0,12.0,7.0,6.0,2.0,2.0,3.0,1.0,0.0,0.0,1.0,50.0,35.0,34.0,52.0,52.0,37.0,38.0,42.0,38.0,54.0,39.0,60.0,49.0,54.0,50.0,41.0,57.0,76.0,63.0,70.0,70.0,98.0,79.0,76.0,106.0,83.0,60.0,91.0,75.0,64.0,91.0,77.0,65.0,84.0,69.0,51.0,71.0,56.0,48.0,78.0,64.0,56.0,49.0,46.0,69.0,57.0,57.0,48.0,30.0,42.0,29.0,34.0,24.0,22.0,23.0,8.0,9.0,3.0,3.0,3.0,0.0,0.0,0.0,11.066599900000002,12.41830065,12.93031066,236,109,244,129,274,140,210,112,244,137,274,168,266,308,446,462,505,22.33350025,21.56862745,21.2006717,106.94300520000002,107.5581395,104.9913941,1330,1414,1569,66.59989985,66.0130719,65.86901763,254.53383459999998,298.6732673,340.1861058,33.53383459,32.67326733,32.1861058,201.8099548,173.6842105,163.961039,1142,57.18577867,31.65266106,678,30.52057095,727,92.10526316,161.038961,141.0714286,47.66839378,460,15.0,80.32945736,829,10.97708082,36.14457831,420,20.71428571,7.391304347999999,4.221954162,11.9047619,27424.503010000004,42221580.6,2382.0,2303.0,2276.0,2257.0,2223.0,2231.0,2267.0,2215.0,2197.0,2186.0,2141.0,2142.0,2117.0,2081.0,2065.0,2046.0,2032.0,2007.0,1997.0,2008.0,1976.0,1991.0,1985.0,2006.0,2025.5,2045.0,2002.0,2144.0,2358.0,2514.0,2873.0,2771.0,2552.0,2273.0,2111.0,2132.0,42.22158051,50.49550429999999,49.99812832,53.83502874,60.44302391,65.62994485,68.04577104,59.54301023,55.84821723,50.77971915,47.41651014,48.43494667,47.97309754,47.51124842,47.01387244,47.15597986,46.800711299999996,47.55861756,47.29808728,47.53493299,48.12704725,48.45863124,48.90863808,49.28759121,50.14023574,50.73235001,50.70866544,51.77447111,52.03500138,52.46132365,53.69292132,52.84027678,52.65080022,53.45607561,53.90608245,54.54556586,56.41664693,0,1,2,0,2,13004.246579999999,4328.391516,2748.1140920000003,6137.898295,2175.725196,18,151,0.000223634,0,1.0,1.0,1.0,1.0
39063,2444,Cantabria,Cantabria,Rionansa,101,2002,1901,667.643642,363.651638,0.122584,51.717514,51.59493,19.161141,7.910147,27074.57173,35933.8461,8859.274373999999,31231.384110000003,1878.0976100000003,6695.397245,16649.102759999998,9953.705512999999,11774.18057,2162.325269,6382.4586899999995,23855.10641,17472.647719999997,14842.6191,4617.599889,5236.321365999999,22450.87347,17214.5521,13630.69914,4426.595489,6.0,5.0,3.0,3.0,6.0,2.0,2,4,7,3,1,1,6,3,5,8,9,8,8,7,5,17.0,17.0,19.0,10.0,16.0,17.0,27,18,19,20,18,22,20,16,18,22,28,18,18,23,20,-11,-12,-16,-7,-10,-15,-25,-14,-12,-17,-17,-21,-14,-13,-13,-14,-19,-10,-10,-16,-15,31.41361257,26.17801047,16.57458564,17.24137931,35.92814371,12.26993865,12.98701299,27.21088435,51.47058824,22.90076336,7.874015748,8.403361345,51.72413793,30.303030300000003,55.55555556,83.33333333,108.43373490000002,96.38554217,103.89610390000001,89.74358974,75.94936709,89.0052356,89.0052356,104.9723757,57.47126437,95.80838323,104.2944785,175.3246753,122.44897959999999,139.7058824,152.67175569999998,141.7322835,184.8739496,172.4137931,161.6161616,200.0,229.16666669999998,318.1818182,216.8674699,233.7662338,294.87179489999994,253.16455699999997,-57.59162304,-62.82722513,-88.39779006,-40.22988506,-59.88023952,-92.02453988,-162.3376623,-95.23809524,-88.23529412,-129.7709924,-133.85826770000003,-176.4705882,-120.68965520000002,-131.3131313,-144.4444444,-145.83333330000002,-215.9090909,-120.4819277,-129.87012990000002,-205.1282051,-189.8734177,29,29,0,23,22,1,6,7,-1,40,31,9,40,36,4,0,-5,5,44,42,2,26,24,2,18,18,0,48,44,4,28,21,7,20,23,-3,55,50,5,39,38,1,16,12,4,50,46,4,36,32,4,14,14,0,72,67,5,43,42,1,29,25,4,50,45,5,47,46,1,3,-1,4,70,61,9,36,35,1,34,26,8,31.0,18.0,23.0,23.0,19.0,32.0,19.0,23.0,65.0,18.0,33.0,61.0,25.0,59.0,70.0,40.0,41.0,77.0,53.0,68.0,80.0,48.0,56.0,83.0,64.0,72.0,109.0,59.0,93.0,93.0,77.0,100.0,82.0,92.0,84.0,68.0,108.0,78.0,54.0,98.0,55.0,95.0,84.0,73.0,110.0,59.0,90.0,106.0,48.0,82.0,65.0,58.0,51.0,33.0,27.0,16.0,11.0,11.0,2.0,0.0,0.0,0.0,0.0,16.0,9.0,13.0,10.0,7.0,16.0,8.0,8.0,31.0,10.0,20.0,29.0,13.0,32.0,37.0,24.0,23.0,47.0,29.0,43.0,52.0,21.0,39.0,43.0,41.0,48.0,72.0,39.0,61.0,67.0,46.0,70.0,55.0,57.0,54.0,38.0,68.0,42.0,30.0,67.0,30.0,52.0,46.0,37.0,64.0,33.0,42.0,54.0,16.0,40.0,30.0,26.0,26.0,10.0,9.0,5.0,4.0,2.0,1.0,0.0,0.0,0.0,0.0,15.0,9.0,10.0,13.0,12.0,16.0,11.0,15.0,34.0,8.0,13.0,32.0,12.0,27.0,33.0,16.0,18.0,30.0,24.0,25.0,28.0,27.0,17.0,40.0,23.0,24.0,37.0,20.0,32.0,26.0,31.0,30.0,27.0,35.0,30.0,30.0,40.0,36.0,24.0,31.0,25.0,43.0,38.0,36.0,46.0,26.0,48.0,52.0,32.0,42.0,35.0,32.0,25.0,23.0,18.0,11.0,7.0,9.0,1.0,0.0,0.0,0.0,0.0,9.111617312,5.39083558,7.005758157000001,206,60,188,36,186,39,214,60,188,24,186,34,60,73,420,369,385,31.89066059,33.15363881,36.94817658,129.84293190000002,133.8235294,126.0303688,777,684,584,58.997722100000004,61.45552561,56.04606526,174.0540541,113.94736840000002,138.9246575,54.05405405,53.94736842,65.92465753,350.0,615.0,527.3972603,553,41.98936978,25.96585804,289,21.49712092,224,88.52459016,236.36363640000002,600.0,48.86561955,280,8.214285713999999,69.11764706,329,5.47112462,29.93492408,138,22.46376812,3.571428571,2.73556231,10.86956522,57399.75871,118092087.8,1042.0,1029.0,1047.0,1038.0,1045.0,1058.0,1051.0,1053.0,1078.0,1091.0,1112.0,1113.0,1131.0,1144.0,1190.0,1215.0,1262.0,1289.0,1317.0,1341.0,1393.0,1444.0,1471.0,1495.0,1528.0,1561.0,1481.0,1752.0,2061.0,2340.0,2674.0,2083.0,2081.0,2181.0,1896.0,1519.0,118.0920868,12.86284324,16.05526714,18.46863799,17.6218412,17.63877713,22.64334616,19.81504488,17.45248184,14.83587976,12.54106046,13.21849789,12.93905495,12.65961201,12.45638078,12.22774565,11.79587928,11.35554495,11.15231372,10.91521062,10.68657549,10.288581,10.0768818,9.687355276,9.577271693,9.424848271,9.416380303,9.238552977000001,9.128469394,8.916770197,8.899834261,8.959110036,8.849026454,8.789750677999999,8.86596239,8.713538967,8.82362255,0,0,0,1,1,32327.21297,9669.37931,13226.75784,7201.987506,4374.534111,8,36,0.013384989,0,0.63,0.0,1.0,1.0
39069,2445,Cantabria,Cantabria,San Felices de Buelna,53,749,696,312.33653799999996,157.453419,0.0,46.073116,46.073116,13.204654999999999,8.09972,4225.843552,12951.7111,8725.867544,7995.551851,2193.395214,93.69628900000001,4906.291889,4812.595601,3058.841746,1138.8770769999999,395.257021,6321.652381,5926.395359,3741.38895,1363.204371,35.26267,5848.152201,5812.889531,3282.530332,1324.983721,15.0,6.0,13.0,20.0,20.0,19.0,19,20,14,22,29,29,20,23,12,17,20,19,19,20,5,25.0,23.0,26.0,35.0,26.0,20.0,27,32,21,27,25,26,23,30,32,25,24,29,24,31,35,-10,-17,-13,-15,-6,-1,-8,-12,-7,-5,4,3,-3,-7,-20,-8,-4,-10,-5,-11,-30,84.74576271,37.5,82.27848101,118.3431953,123.4567901,119.4968553,118.75,121.95121950000001,87.5,139.24050630000002,181.25,192.05298009999998,136.0544218,163.1205674,88.23529412,126.8656716,149.2537313,141.7910448,150.79365080000002,157.480315,131.5789474,141.2429379,143.75,164.556962,207.1005917,160.4938272,125.7861635,168.75,195.12195119999998,131.25,170.8860759,156.25,172.1854305,156.46258500000002,212.7659574,235.2941176,186.5671642,180.45112780000002,216.41791040000004,190.4761905,244.09448819999997,307.01754389999996,-56.49717514,-106.25,-82.27848101,-88.75739645,-37.03703704,-6.289308176,-50.0,-73.17073171,-43.75,-31.64556962,25.0,19.86754967,-20.40816327,-49.64539007,-147.05882350000002,-59.70149254,-30.07518797,-74.62686567,-39.68253968,-86.61417323,-263.1578947,94,88,6,57,53,4,37,35,2,67,64,3,54,50,4,13,14,-1,93,88,5,58,52,6,35,36,-1,63,63,0,88,87,1,-25,-24,-1,99,92,7,57,52,5,42,40,2,68,66,2,92,79,13,-24,-13,-11,80,71,9,102,98,4,-22,-27,5,73,64,9,59,54,5,14,10,4,82,81,1,65,63,2,17,18,-1,93.0,107.0,54.0,111.0,83.0,69.0,127.0,71.0,96.0,97.0,93.0,157.0,80.0,137.0,171.0,95.0,170.0,183.0,135.0,178.0,150.0,171.0,174.0,173.0,187.0,194.0,167.0,203.0,177.0,133.0,183.0,147.0,149.0,170.0,153.0,123.0,159.0,129.0,112.0,134.0,119.0,149.0,126.0,111.0,150.0,98.0,123.0,87.0,85.0,90.0,53.0,71.0,33.0,37.0,26.0,17.0,14.0,4.0,6.0,3.0,0.0,0.0,0.0,56.0,62.0,32.0,62.0,39.0,34.0,69.0,41.0,54.0,42.0,44.0,81.0,50.0,71.0,92.0,48.0,98.0,98.0,65.0,94.0,62.0,96.0,87.0,89.0,93.0,102.0,92.0,111.0,96.0,74.0,96.0,86.0,67.0,97.0,78.0,58.0,82.0,54.0,58.0,64.0,62.0,64.0,59.0,43.0,79.0,43.0,54.0,39.0,32.0,35.0,13.0,21.0,6.0,9.0,8.0,1.0,1.0,0.0,0.0,0.0,0.0,0.0,0.0,37.0,45.0,22.0,49.0,44.0,35.0,58.0,30.0,42.0,55.0,49.0,76.0,30.0,66.0,79.0,47.0,72.0,85.0,70.0,84.0,88.0,75.0,87.0,84.0,94.0,92.0,75.0,92.0,81.0,59.0,87.0,61.0,82.0,73.0,75.0,65.0,77.0,75.0,54.0,70.0,57.0,85.0,67.0,68.0,71.0,55.0,69.0,48.0,53.0,55.0,40.0,50.0,27.0,28.0,18.0,16.0,13.0,4.0,6.0,3.0,0.0,0.0,0.0,9.820627802999999,11.28892734,14.0552017,288,99,298,119,317,144,205,120,298,142,317,187,261,331,493,499,544,22.10762332,21.58304498,23.09978769,96.64902998,99.48231234,102.8423773,1518,1552,1480,68.07174888,67.12802768,62.84501062,251.47694330000002,293.1520619,367.7567568,32.47694335,32.15206186,36.75675676,225.11415530000002,191.1877395,164.35045319999998,405,18.16143498,31.271626300000005,723,29.55414013,696,71.33757962,138.7096774,163.91752580000002,45.32627866,514,10.50583658,81.62208801,946,11.31078224,33.93626184,394,23.60406091,4.2801556419999995,4.756871036000001,9.390862944,25549.95997,36233975.99,2355.0,2367.0,2361.0,2387.0,2421.0,2381.0,2408.0,2394.0,2388.0,2355.0,2318.0,2312.0,2314.0,2309.0,2271.0,2239.0,2241.0,2233.0,2230.0,2209.0,2207.0,2168.0,2176.0,2176.0,2203.0,2230.0,2338.0,2497.0,2854.0,3362.0,2719.0,2503.0,2143.0,1597.0,1538.0,1404.0,36.23397446,38.74816442,42.44635106,44.07465711,59.14338772,69.07881450000001,75.04007056,92.78584672,78.7658556,68.91322405,64.52507723,61.54444919,60.79929218,60.05413518,60.05413518,59.83334791,60.90968582,60.96488263,61.54444919,61.62724442,61.84803168,61.79283486,62.67598391,63.724723399999995,63.86271544,63.80751862,63.97310907,64.99425016,65.90499761,66.07058806,66.45696576,65.71180876,66.81574507,65.87739920000001,65.1598406,65.32543105,64.99425016,0,1,4,0,1,10850.76949,5371.763913000001,2538.859335,4163.032015999999,2432.804922,1,6,0.0023801720000000003,0,1.0,1.0,1.0,1.0
39064,2446,Cantabria,Cantabria,Riotuerto,45,690,645,272.745389,160.518497,0.0,45.122505,45.122505,13.474448,7.458869,9094.555133,17679.01825,8584.463117,13111.070459999999,2121.8955809999998,2875.0400019999997,10096.0457,7221.005695000001,6270.408472,1779.447096,3148.920111,9668.47868,6519.55857,6278.660397,1574.101918,23.425168,7508.989067,7485.563899,3347.5245800000002,1812.980062,13.0,8.0,6.0,10.0,7.0,7.0,14,16,20,14,14,12,15,8,7,8,9,14,5,11,12,14.0,11.0,20.0,18.0,15.0,13.0,10,13,15,21,20,19,20,21,22,13,24,17,18,12,18,-1,-3,-14,-8,-8,-6,4,3,5,-7,-6,-7,-5,-13,-15,-5,-15,-3,-13,-1,-6,11.98156682,7.380073801,5.639097744,9.487666034,6.597549482,6.692160612,13.59223301,15.67091087,19.84126984,14.056224900000002,14.44788442,12.42236025,15.72327044,8.528784648,7.551240561,8.75273523,10.29748284,16.01830664,5.8343057179999995,13.44743276,15.79586877,12.90322581,10.14760148,18.79699248,17.07779886,14.13760603,12.42829828,9.708737864,12.73261508,14.88095238,21.08433735,20.63983488,19.66873706,20.96436059,22.3880597,23.73247033,14.22319475,26.66666667,19.45080092,21.00350058,14.66992665,21.87120292,-0.921658986,-2.767527675,-13.15789474,-7.590132827,-7.54005655,-5.736137667,3.8834951460000005,2.938295788,4.96031746,-7.02811245,-6.191950464,-7.246376812,-5.2410901469999995,-13.85927505,-16.18122977,-5.470459518999999,-16.66666667,-3.4324942789999997,-15.16919487,-1.222493888,-7.2904009720000005,60,55,5,67,65,2,-7,-10,3,50,48,2,67,63,4,-17,-15,-2,117,114,3,59,54,5,58,60,-2,46,42,4,71,60,11,-25,-18,-7,72,70,2,51,45,6,21,25,-4,51,47,4,54,51,3,-3,-4,1,73,62,11,65,63,2,8,-1,9,66,58,8,56,51,5,10,7,3,103,95,8,65,63,2,38,32,6,53.0,75.0,49.0,52.0,48.0,63.0,83.0,70.0,66.0,55.0,69.0,91.0,65.0,75.0,115.0,85.0,110.0,113.0,90.0,119.0,92.0,97.0,114.0,115.0,123.0,126.0,119.0,135.0,126.0,114.0,131.0,119.0,106.0,126.0,107.0,83.0,140.0,99.0,63.0,108.0,77.0,99.0,101.0,78.0,92.0,65.0,79.0,79.0,58.0,72.0,44.0,47.0,38.0,27.0,23.0,9.0,14.0,8.0,6.0,1.0,0.0,1.0,1.0,28.0,40.0,25.0,27.0,23.0,28.0,43.0,34.0,34.0,29.0,37.0,48.0,32.0,40.0,46.0,36.0,54.0,56.0,51.0,56.0,42.0,45.0,64.0,56.0,52.0,65.0,54.0,70.0,62.0,61.0,64.0,58.0,57.0,62.0,55.0,45.0,66.0,53.0,31.0,53.0,41.0,48.0,54.0,37.0,48.0,28.0,36.0,34.0,27.0,29.0,16.0,15.0,14.0,8.0,5.0,1.0,5.0,3.0,2.0,0.0,0.0,0.0,0.0,25.0,35.0,24.0,25.0,25.0,35.0,40.0,36.0,32.0,26.0,32.0,43.0,33.0,35.0,69.0,49.0,56.0,57.0,39.0,63.0,50.0,52.0,50.0,59.0,71.0,61.0,65.0,65.0,64.0,53.0,67.0,61.0,49.0,64.0,52.0,38.0,74.0,46.0,32.0,55.0,36.0,51.0,47.0,41.0,44.0,37.0,43.0,45.0,31.0,43.0,28.0,32.0,24.0,19.0,18.0,8.0,9.0,5.0,4.0,1.0,0.0,1.0,1.0,11.51358344,11.93568336,11.42857143,198,91,200,96,225,90,159,87,200,97,225,98,193,188,357,360,410,23.09184994,22.26345083,24.92401216,92.28855721,98.16176471,92.39766082,1011,1064,1047,65.39456662,65.8008658,63.64741641,213.3115727,226.83458650000003,227.15950330000004,35.3115727,33.83458647,39.15950334,200.56179780000002,186.52849740000002,218.08510640000003,604,39.06856404,29.99381571,485,27.05167173,445,69.23076923,143.4782609,254.5454545,37.56218905,302,16.22516556,75.12254902,613,12.23491028,28.65497076,245,21.63265306,7.947019868,5.709624796,10.20408163,25685.83546,30348838.66,1645.0,1611.0,1601.0,1609.0,1615.0,1610.0,1638.0,1594.0,1622.0,1634.0,1627.0,1617.0,1627.0,1612.0,1578.0,1536.0,1522.0,1511.0,1546.0,1524.0,1522.0,1509.0,1520.0,1537.0,1536.0,1535.0,1542.0,1628.0,1829.0,2334.0,2140.0,2225.0,2522.0,2318.0,2173.0,2068.0,30.34883881,68.14099258,71.60076252,76.37854004,83.10037877,73.31417239,70.51340625,76.90574308,60.26589721,53.64290905,50.80919273,50.5785414,50.61149159,50.64444178,50.08428855,49.72183646,50.15018893,50.21608931,50.94099349,49.78773684,50.15018893,50.61149159,51.99539956,53.11570602,53.60995887,53.28045697,53.60995887,53.84061019,53.44520792,52.522602600000006,53.97241095,53.04980564,53.21455659,53.01685545,52.75325393,53.08275583,54.20306228,0,1,14,0,1,17796.90716,6018.847343,1807.4822960000001,5074.587575,2678.750321,23,177,0.00011109700000000001,0,0.0,0.0,0.99,0.96
39070,2447,Cantabria,Cantabria,San Miguel de Aguayo,708,1319,611,958.996225,105.577849,0.0,36.369904,36.369904,12.52742,6.67328,9035.089842,17473.74106,8438.651222,13053.91817,2107.951955,1236.76821,7419.202020000001,6182.43381,4836.7357520000005,1504.759012,2334.534037,9854.856032,7520.321995,5937.257715,1833.9026420000002,1670.931294,9340.226343,7669.295048999999,5442.537671,1756.349525,0.0,0.0,1.0,1.0,1.0,1.0,0,2,1,1,1,1,0,2,0,2,2,0,0,3,1,3.0,1.0,1.0,2.0,5.0,2.0,0,0,1,1,0,0,3,3,7,2,1,2,5,1,1,-3,-1,0,-1,-4,-1,0,2,0,0,1,1,-3,-1,-7,0,1,-2,-5,2,0,0,0,9.433962264,9.615384615,9.803921569,10.1010101,0.0,20.40816327,10.1010101,10.41666667,9.900990099,9.708737864,0.0,20.83333333,0.0,22.98850575,25.3164557,0.0,0.0,38.96103896,0.0,27.27272727,9.174311927,9.433962264,19.23076923,49.01960784,20.2020202,0.0,0.0,10.1010101,10.41666667,0.0,0.0,31.25,31.25,70.70707071,22.98850575,11.9047619,25.3164557,66.66666667,12.98701299,13.69863014,-27.27272727,-9.174311927,0,-9.615384615,-39.21568627,-10.1010101,0.0,20.40816327,0.0,0.0,9.900990099,9.708737864,-31.25,-10.41666667,-70.70707071,0.0,11.9047619,-25.3164557,-66.66666667,25.97402597,0.0,7,6,1,2,2,0,5,4,1,3,3,0,5,4,1,-2,-1,-1,5,5,0,9,8,1,-4,-3,-1,0,0,0,3,3,0,-3,-3,0,2,2,0,7,7,0,-5,-5,0,1,1,0,6,6,0,-5,-5,0,2,2,0,4,4,0,-2,-2,0,4,3,1,1,1,0,3,2,1,5,5,0,2,2,0,3,3,0,5.0,5.0,2.0,5.0,2.0,5.0,4.0,5.0,11.0,4.0,8.0,11.0,3.0,12.0,3.0,11.0,5.0,6.0,8.0,7.0,13.0,10.0,12.0,14.0,5.0,15.0,10.0,11.0,13.0,10.0,19.0,12.0,8.0,8.0,11.0,9.0,17.0,7.0,6.0,9.0,7.0,10.0,7.0,11.0,11.0,7.0,9.0,13.0,4.0,10.0,6.0,8.0,6.0,5.0,3.0,1.0,2.0,0.0,1.0,0.0,0.0,0.0,0.0,4.0,4.0,2.0,2.0,1.0,3.0,4.0,2.0,6.0,2.0,6.0,7.0,2.0,4.0,1.0,5.0,2.0,4.0,3.0,3.0,5.0,3.0,6.0,8.0,3.0,7.0,10.0,6.0,11.0,4.0,9.0,7.0,5.0,7.0,5.0,3.0,11.0,3.0,3.0,6.0,4.0,6.0,2.0,5.0,5.0,4.0,4.0,5.0,1.0,4.0,4.0,3.0,3.0,2.0,1.0,0.0,0.0,0.0,0.0,0.0,0.0,0.0,0.0,1.0,1.0,0.0,3.0,1.0,2.0,0.0,3.0,5.0,2.0,2.0,4.0,1.0,8.0,2.0,6.0,3.0,2.0,5.0,4.0,8.0,7.0,6.0,6.0,2.0,8.0,0.0,5.0,2.0,6.0,10.0,5.0,3.0,1.0,6.0,6.0,6.0,4.0,3.0,3.0,3.0,4.0,5.0,6.0,6.0,3.0,5.0,8.0,3.0,6.0,2.0,5.0,3.0,3.0,2.0,1.0,2.0,0.0,1.0,0.0,0.0,0.0,0.0,11.61290323,7.547169811,9.459459459,25,7,25,5,21,4,22,11,25,7,21,10,12,14,47,45,38,30.32258065,28.30188679,25.67567568,115.2777778,103.8461538,111.42857140000001,90,102,96,58.06451613,64.1509434,64.86486486,70.22222222,56.11764706,53.58333333,52.22222222,44.11764706,39.58333333,261.1111111,375.0,271.42857139999995,336,216.7741935,29.55974843,47,22.97297297,34,54.54545455,87.5,425.0,48.61111111,35,5.714285714,75.64102564,59,8.474576271,25.71428571,18,27.77777778,0.0,1.694915254,5.555555556,24346.82832,36160566.29,148.0,145.0,140.0,147.0,154.0,160.0,164.0,174.0,175.0,174.0,166.0,159.0,157.0,153.0,149.0,142.0,144.0,151.0,155.0,152.0,151.0,158.0,160.0,156.0,157.5,159.0,132.0,192.0,241.0,330.0,378.0,385.0,428.0,493.0,449.0,446.0,36.16056442,12.33387828,12.41684158,13.63363675,11.83609844,10.64695771,10.45337666,9.125963747,6.664718979,5.309651635,3.650385499,4.39705526,4.355573607,4.314091953,4.424709696,4.3694008239999995,4.175819775,4.2034742110000005,4.2864375180000005,4.175819775,3.9822387260000003,3.926929855,4.120510904,4.231128646,4.341746389,4.39705526,4.590636309,4.811871794,4.83952623,4.811871794,4.535327438,4.424709696,4.258783082,4.065202033,3.8716209839999998,4.009893162,4.092856468,0,0,0,0,1,32790.14207,4073.323568,7165.640206,11866.28345,2728.297618,0,0,4.444083563,0,0.29,0.0,1.0,1.0
39065,2448,Cantabria,Cantabria,Rozas de Valdearroyo (Las),801,1134,333,901.0692650000001,66.99889,0.0,28.537190999999996,28.537190999999996,6.811106,5.439717,5168.5163840000005,15765.24055,10596.72417,10554.79068,2443.890127,3875.7733670000002,11225.08841,7349.315038,8011.635301,1835.3760329999998,3958.5011729999997,12465.831740000001,8507.330565,8502.897906999999,2174.896747,5071.5608170000005,12127.38706,7055.82624,8926.150364,1845.200909,0.0,0.0,1.0,1.0,0.0,0.0,4,1,0,1,1,0,1,2,0,1,0,1,2,2,2,4.0,4.0,5.0,4.0,1.0,2.0,4,2,4,4,4,4,2,7,3,6,4,2,1,4,3,-4,-4,-4,-3,-1,-2,0,-1,-4,-3,-3,-4,-1,-5,-3,-5,-4,-1,1,-2,-1,0,0,0.61500615,0.600240096,0,0,2.281802624,0.557724484,0.0,0.53361793,0.534759358,0.0,0.525210084,1.044932079,0.0,0.5282620179999999,0.0,0.535905681,1.076426265,1.098297639,0.0,2.473716759,2.466091245,3.07503075,2.400960384,0.599161174,1.178550383,2.281802624,1.115448968,2.149382053,2.134471718,2.139037433,2.123142251,1.050420168,3.657262278,1.566579634,3.169572108,2.127659574,1.071811361,0.538213132,2.1965952769999997,1.6574585640000001,-2.473716759,-2.466091245,-2.4600246,-1.800720288,-0.599161174,-1.178550383,0.0,-0.557724484,-2.149382053,-1.600853789,-1.604278075,-2.123142251,-0.525210084,-2.612330199,-1.566579634,-2.64131009,-2.127659574,-0.535905681,0.538213132,-1.098297639,-0.5524861879999999,11,11,0,15,14,1,-4,-3,-1,13,12,1,10,9,1,3,3,0,20,18,2,15,14,1,5,4,1,19,19,0,15,15,0,4,4,0,10,10,0,16,16,0,-6,-6,0,18,15,3,12,12,0,6,3,3,17,17,0,25,25,0,-8,-8,0,11,9,2,21,20,1,-10,-11,1,17,16,1,7,7,0,10,9,1,11.0,9.0,9.0,9.0,5.0,9.0,11.0,5.0,7.0,4.0,6.0,9.0,9.0,7.0,19.0,12.0,22.0,23.0,9.0,13.0,14.0,18.0,15.0,30.0,16.0,20.0,35.0,19.0,24.0,21.0,17.0,28.0,21.0,30.0,20.0,7.0,27.0,19.0,13.0,20.0,9.0,18.0,14.0,18.0,25.0,8.0,12.0,21.0,9.0,20.0,10.0,8.0,10.0,9.0,5.0,7.0,5.0,0.0,1.0,1.0,1.0,1.0,0.0,6.0,5.0,5.0,5.0,2.0,5.0,5.0,3.0,5.0,1.0,4.0,6.0,4.0,4.0,11.0,7.0,13.0,12.0,5.0,8.0,8.0,8.0,10.0,23.0,9.0,15.0,18.0,11.0,15.0,10.0,11.0,16.0,13.0,21.0,10.0,4.0,16.0,11.0,6.0,10.0,6.0,12.0,9.0,7.0,16.0,7.0,9.0,9.0,3.0,10.0,4.0,4.0,5.0,5.0,1.0,1.0,1.0,0.0,0.0,0.0,0.0,0.0,0.0,5.0,4.0,4.0,4.0,3.0,4.0,6.0,2.0,2.0,3.0,2.0,3.0,5.0,3.0,8.0,5.0,9.0,11.0,4.0,5.0,6.0,10.0,5.0,7.0,7.0,5.0,17.0,8.0,9.0,11.0,6.0,12.0,8.0,9.0,10.0,3.0,11.0,8.0,7.0,10.0,3.0,6.0,5.0,11.0,9.0,1.0,3.0,12.0,6.0,10.0,6.0,4.0,5.0,4.0,4.0,6.0,4.0,0.0,1.0,1.0,1.0,1.0,0.0,8.169934641000001,7.011070111,12.06225681,42,10,40,9,31,15,47,15,40,10,31,16,19,31,89,78,65,29.08496732,28.78228782,25.29182879,130.075188,131.6239316,125.4385965,192,174,161,62.74509804,64.20664207,62.645914399999995,71.35416667,63.82758621,71.37267081,46.35416667,44.82758621,40.37267081,356.0,410.5263158,209.67741940000002,58,18.95424837,26.56826568,72,24.12451362,62,144.4444444,316.6666667,675.0,58.64661654,78,11.53846154,70.94017094,83,10.84337349,29.8245614,34,32.35294118,5.128205128,4.8192771080000005,14.70588235,37156.881519999995,57486737.79,257.0,247.0,260.0,268.0,264.0,275.0,282.0,281.0,284.0,288.0,295.0,271.0,283.0,300.0,307.0,292.0,301.0,319.0,306.0,317.0,317.0,325.0,322.0,289.0,293.5,298.0,255.0,341.0,540.0,1028.0,1731.0,2394.0,2858.0,2713.0,2173.0,2059.0,57.486736300000004,35.81695766,37.8000238,47.19349496,49.71581593,41.64438885,30.11129369,17.88238585,9.393471169,5.93180309,4.43580583,5.18380446,5.105525533,5.0272466069999995,5.601292067,5.6534780179999995,5.514315482000001,5.514315482000001,5.322966996,5.549106116,5.235990411,5.079432558,5.340362313,5.218595093999999,4.922874705,4.714130901,5.131618509,5.00985129,4.940270022,4.888084071000001,4.905479388,4.783712169,4.592363683,4.66194495,4.522782415,4.296643294,4.470596464,0,1,0,0,1,44179.8355,5677.0206880000005,7988.201459999999,10047.326959999999,2684.700457,2,22,4.53892e-05,0,0.0,0.0,1.0,1.0
39066,2449,Cantabria,Cantabria,Ruente,161,963,802,460.77030199999996,169.170668,0.122584,45.501812,45.379228000000005,15.694237,7.381783,15133.96666,24009.08684,8875.120179000001,19642.79361,1998.71395,3403.0347039999997,12457.50825,9054.473544,8252.872397,2182.281667,4260.831633,12854.19382,8593.362183,8698.703003,1978.6188350000002,3579.2840549999996,12390.20971,8810.925651000001,8271.264611,2155.345358,9.0,8.0,9.0,5.0,8.0,9.0,4,6,2,11,10,6,2,7,7,10,8,0,5,7,9,14.0,11.0,8.0,11.0,7.0,13.0,7,8,10,13,7,9,16,11,9,12,12,11,5,7,17,-5,-3,1,-6,1,-4,-3,-2,-8,-2,3,-3,-14,-4,-2,-2,-4,-11,0,0,-8,17.50972763,15.18026565,16.63585952,9.746588694,15.53398058,17.78656126,8.230452675,12.12121212,4.073319756,23.20675105,20.87682672,12.65822785,4.3859649119999995,15.25054466,15.02145923,21.55172414,18.64801865,0.0,11.96172249,16.94915254,22.55639098,27.23735409,20.87286528,14.78743068,21.44249513,13.59223301,25.6916996,14.40329218,16.16161616,20.36659878,27.42616034,14.61377871,18.98734177,35.087719299999996,23.96514161,19.31330472,25.86206897,26.66666667,25.64102564,11.96172249,16.94915254,42.60651629,-9.727626459,-5.69259962,1.848428835,-11.69590643,1.941747573,-7.90513834,-6.172839506,-4.04040404,-16.29327902,-4.219409283,6.263048017000001,-6.329113924,-30.70175439,-8.71459695,-4.2918454939999995,-4.310344828,-8.888888889,-25.64102564,0.0,0.0,-20.05012531,45,45,0,41,35,6,4,10,-6,42,41,1,42,38,4,0,3,-3,42,40,2,38,35,3,4,5,-1,34,33,1,28,26,2,6,7,-1,25,23,2,33,31,2,-8,-8,0,29,27,2,22,21,1,7,6,1,40,34,6,55,55,0,-15,-21,6,39,37,2,45,44,1,-6,-7,1,62,60,2,29,29,0,33,31,2,27.0,34.0,38.0,36.0,46.0,19.0,43.0,29.0,28.0,42.0,30.0,42.0,44.0,37.0,76.0,30.0,80.0,81.0,35.0,92.0,80.0,87.0,86.0,69.0,89.0,75.0,79.0,87.0,92.0,76.0,76.0,78.0,66.0,81.0,72.0,62.0,84.0,80.0,44.0,76.0,55.0,57.0,67.0,48.0,47.0,47.0,50.0,48.0,45.0,25.0,39.0,30.0,33.0,17.0,6.0,4.0,6.0,2.0,2.0,2.0,0.0,0.0,1.0,13.0,14.0,18.0,19.0,16.0,10.0,23.0,14.0,16.0,15.0,17.0,25.0,21.0,22.0,39.0,19.0,45.0,42.0,18.0,51.0,44.0,45.0,52.0,37.0,49.0,38.0,49.0,48.0,57.0,47.0,46.0,45.0,32.0,49.0,39.0,39.0,48.0,44.0,25.0,43.0,33.0,30.0,35.0,32.0,26.0,28.0,19.0,22.0,24.0,14.0,14.0,12.0,11.0,8.0,3.0,2.0,1.0,1.0,0.0,0.0,0.0,0.0,0.0,14.0,20.0,20.0,17.0,30.0,9.0,20.0,15.0,12.0,27.0,13.0,17.0,23.0,15.0,37.0,11.0,35.0,39.0,17.0,41.0,36.0,42.0,34.0,32.0,40.0,37.0,30.0,39.0,35.0,29.0,30.0,33.0,34.0,32.0,33.0,23.0,36.0,36.0,19.0,33.0,22.0,27.0,32.0,16.0,21.0,19.0,31.0,26.0,21.0,11.0,25.0,18.0,22.0,9.0,3.0,2.0,5.0,1.0,2.0,2.0,0.0,0.0,1.0,8.700102354,10.40076336,10.25145068,116,41,106,65,127,51,101,44,106,44,127,55,109,106,217,217,273,22.21084954,20.70610687,26.40232108,115.6732892,116.9772257,117.68421049999999,675,722,655,69.08904811,68.89312977,63.34622824,117.14814809999999,139.0554017,147.67938930000003,32.14814815,30.05540166,41.67938931,255.2941176,199.08256880000002,257.5471698,155,15.86489253,32.91984733,345,28.82011605,298,104.7619048,266.6666667,200.0,52.09713024,236,16.10169492,82.81573499,400,8.5,35.15789474,167,16.16766467,8.474576271,5.0,8.383233533,38664.12395,66136901.71,1034.0,1011.0,1016.0,1026.0,1031.0,1044.0,1037.0,1034.0,1035.0,1041.0,1052.0,1048.0,1022.0,1003.0,1022.0,1001.0,1003.0,985.0,977.0,966.0,969.0,955.0,966.0,953.0,951.0,949.0,937.0,972.0,1064.0,1083.0,1146.0,1189.0,1193.0,1205.0,1138.0,1145.0,66.13690186,17.31257389,17.20673282,18.219783,18.03834118,17.97786057,17.32769404,16.37512447,16.08784159,14.69678761,14.167582300000001,14.34902412,14.37926442,14.40950473,14.6060667,14.43974503,14.65142716,14.6060667,14.77238837,14.89334959,15.16551232,15.13527202,15.45279521,15.16551232,15.45279521,15.84591916,15.90639976,15.74007809,15.64935718,15.63423703,15.67959749,15.78543855,15.58887657,15.51327581,15.362074300000002,15.28647354,15.63423703,0,0,0,0,1,19360.351169999998,7115.197053,9723.557743000001,7815.938417,3957.77609,22,108,0.000675373,0,0.94,0.0,1.0,1.0
39067,2450,Cantabria,Cantabria,Ruesga,84,1385,1301,467.052504,254.40408599999998,0.0,51.805984,51.805984,17.476096,9.287941,12783.155040000001,22541.18624,9758.031198,17986.7269,1897.6457510000002,1623.203311,16252.5,14629.296690000001,8231.821423000001,3105.210653,7647.765777,17748.523719999997,10100.75795,12608.9015,2342.129794,2567.6942510000003,13756.00706,11188.31281,8787.939682,2294.25737,1.0,6.0,5.0,4.0,5.0,2.0,3,3,3,5,8,2,1,4,7,3,1,1,3,4,3,16.0,15.0,19.0,9.0,15.0,19.0,17,16,23,22,21,13,12,28,19,19,11,8,16,15,17,-15,-9,-14,-5,-10,-17,-14,-13,-20,-17,-13,-11,-11,-24,-12,-16,-10,-7,-13,-11,-14,9.259259259,57.14285714,48.54368932,40.81632653,52.08333333,21.73913043,34.48275862,28.57142857,34.88372093,62.5,105.26315790000001,30.76923077,16.12903226,70.17543859999999,125.0,58.82352941,21.73913043,21.73913043,68.18181818,88.88888889,22.72727273,148.1481481,142.8571429,184.4660194,91.83673469,156.25,206.5217391,195.4022989,152.38095239999998,267.4418605,275.0,276.3157895,200.0,193.5483871,491.22807019999993,339.2857143,372.54901960000007,239.13043480000002,173.91304350000001,363.63636360000004,333.3333333,386.36363639999996,-138.8888889,-85.71428571,-135.9223301,-51.02040816,-104.1666667,-184.7826087,-160.91954019999997,-123.8095238,-232.5581395,-212.5,-171.05263159999998,-169.23076919999997,-177.4193548,-421.05263160000004,-214.28571430000002,-313.72549019999997,-217.3913043,-152.173913,-295.4545455,-244.4444444,-318.1818182,34,33,1,31,30,1,3,3,0,17,17,0,33,31,2,-16,-14,-2,25,25,0,41,40,1,-16,-15,-1,29,28,1,45,41,4,-16,-13,-3,39,39,0,28,27,1,11,12,-1,58,51,7,50,50,0,8,1,7,29,27,2,50,49,1,-21,-22,1,29,26,3,27,26,1,2,0,2,52,51,1,49,47,2,3,4,-1,11.0,15.0,19.0,16.0,27.0,30.0,21.0,26.0,48.0,20.0,42.0,59.0,22.0,47.0,66.0,28.0,56.0,78.0,41.0,62.0,67.0,44.0,61.0,81.0,48.0,75.0,81.0,63.0,72.0,88.0,64.0,89.0,77.0,79.0,91.0,70.0,74.0,74.0,53.0,91.0,55.0,92.0,60.0,61.0,72.0,51.0,69.0,72.0,46.0,48.0,58.0,29.0,47.0,30.0,16.0,20.0,7.0,2.0,4.0,2.0,0.0,0.0,1.0,2.0,13.0,13.0,9.0,16.0,19.0,13.0,20.0,25.0,13.0,18.0,26.0,15.0,22.0,37.0,16.0,35.0,45.0,25.0,32.0,36.0,23.0,33.0,40.0,33.0,43.0,46.0,35.0,40.0,47.0,42.0,45.0,43.0,43.0,52.0,36.0,35.0,35.0,30.0,52.0,34.0,42.0,27.0,22.0,43.0,30.0,40.0,39.0,20.0,26.0,24.0,13.0,17.0,11.0,7.0,3.0,3.0,0.0,0.0,0.0,0.0,0.0,0.0,9.0,2.0,6.0,7.0,11.0,11.0,8.0,6.0,23.0,7.0,24.0,33.0,7.0,25.0,29.0,12.0,21.0,33.0,16.0,30.0,31.0,21.0,28.0,41.0,15.0,32.0,35.0,28.0,32.0,41.0,22.0,44.0,34.0,36.0,39.0,34.0,39.0,39.0,23.0,39.0,21.0,50.0,33.0,39.0,29.0,21.0,29.0,33.0,26.0,22.0,34.0,16.0,30.0,19.0,9.0,17.0,4.0,2.0,4.0,2.0,0.0,0.0,1.0,8.427454387000001,6.532180596,5.811138015,172,40,162,19,146,24,162,57,162,49,146,24,68,48,334,304,295,29.018245,29.20268972,35.71428571,110.8058608,110.3030303,121.4477212,720,669,483,62.55430061,64.26512968,58.47457627,143.38888889999998,113.4409567,109.07660459999998,46.38888889,45.44095665,61.07660455,344.32989689999994,447.0588235,614.5833332999999,316,27.45438749,25.93659942,270,23.72881356,196,89.83050847,176.19047619999998,370.0,42.12454212,230,8.260869565,69.29292929,343,4.373177843,33.51206434,125,8.8,2.6086956519999998,0.5830903789999999,7.2,57428.44617,87558720.85,826.0,836.0,839.0,872.0,870.0,870.0,903.0,932.0,973.0,981.0,1005.0,1041.0,1060.0,1113.0,1129.0,1109.0,1127.0,1136.0,1151.0,1188.0,1213.0,1224.0,1246.0,1246.0,1263.5,1281.0,1327.0,1420.0,2026.0,2249.0,2671.0,2700.0,2920.0,2723.0,3102.0,2829.0,87.55872345,32.30974469,35.42765218,31.09912859,33.34904719,30.83644774,30.50524145,25.68561888,23.13875671,16.21768733,15.15554302,14.63018132,14.43031545,14.23044959,14.23044959,13.97918964,13.85355967,13.56803701,13.14546346,12.97414986,12.87136171,12.66578539,12.89420352,12.71146901,12.10616097,11.88916374,11.4780111,11.20390935,11.11254209,10.64428492,10.31307863,9.936188717,9.936188717,9.95903053,9.582140613,9.547877892999999,9.433668828,0,0,0,0,2,17875.863869999997,6884.744771,5635.662408,8522.942661,2897.54603,10,47,0.005036737,0,0.0,0.0,0.95,0.92
39068,2451,Cantabria,Cantabria,Ruiloba,-3,311,314,92.37270699999999,66.396863,0.122584,21.837065,21.71448,7.754327,4.34503,14730.80183,19342.58485,4611.783026,16869.0132,1136.151849,5349.645545,9241.334533,3891.6889880000003,7173.979204,879.8893519999999,4687.261384,8865.020719,4177.759335,6772.438647,1034.062187,5528.065703,9418.998563,3890.9328600000003,7361.791606000001,845.963761,5.0,8.0,10.0,7.0,8.0,5.0,4,6,4,4,13,7,7,4,1,3,3,3,4,1,3,5.0,6.0,8.0,8.0,7.0,7.0,5,5,11,7,13,9,15,7,11,8,9,9,16,13,14,0,2,2,-1,1,-2,-1,1,-7,-3,0,-2,-8,-3,-10,-5,-6,-6,-12,-12,-11,5.787037037,9.603841537,12.56281407,8.620689655,9.987515605,6.353240152,5.174644243,7.926023777999999,5.361930295,5.427408412,18.03051318,9.873060649,10.0,5.943536404,1.508295626,4.594180703999999,4.95049505,4.95049505,6.908462867000001,1.751313485,8.992805755,5.787037037,7.202881152,10.05025126,9.852216749,8.739076155,8.894536213,6.468305303999999,6.605019815,14.74530831,9.497964722,18.03051318,12.69393512,21.42857143,10.40118871,16.59125189,12.25114855,14.51612903,14.85148515,27.63385147,22.76707531,25.17985612,0,2.400960384,2.512562814,-1.231527094,1.248439451,-2.541296061,-1.293661061,1.321003963,-9.383378016,-4.070556309,0.0,-2.820874471,-11.42857143,-4.457652303,-15.08295626,-7.656967841,-9.677419355,-9.900990099,-20.725388600000002,-21.01576182,-19.78417266,27,24,3,31,30,1,-4,-6,2,26,26,0,23,22,1,3,4,-1,22,21,1,29,29,0,-7,-8,1,29,25,4,28,26,2,1,-1,2,34,30,4,43,39,4,-9,-9,0,28,21,7,37,36,1,-9,-15,6,44,40,4,30,29,1,14,11,3,36,36,0,43,40,3,-7,-4,-3,53,44,9,26,24,2,27,20,7,17.0,20.0,33.0,23.0,40.0,21.0,25.0,27.0,34.0,30.0,32.0,34.0,22.0,40.0,44.0,30.0,34.0,42.0,55.0,41.0,61.0,40.0,65.0,62.0,45.0,85.0,65.0,62.0,68.0,45.0,74.0,51.0,47.0,75.0,48.0,50.0,57.0,50.0,31.0,47.0,44.0,48.0,39.0,36.0,49.0,40.0,45.0,42.0,23.0,40.0,30.0,22.0,16.0,12.0,12.0,7.0,7.0,2.0,1.0,1.0,1.0,0.0,0.0,8.0,10.0,20.0,9.0,17.0,11.0,9.0,18.0,18.0,13.0,17.0,20.0,15.0,23.0,22.0,16.0,16.0,25.0,31.0,20.0,31.0,17.0,35.0,33.0,23.0,44.0,36.0,38.0,39.0,24.0,33.0,25.0,28.0,40.0,24.0,27.0,27.0,29.0,15.0,28.0,26.0,26.0,25.0,21.0,23.0,18.0,17.0,16.0,13.0,15.0,8.0,7.0,6.0,4.0,5.0,1.0,4.0,0.0,1.0,0.0,0.0,0.0,0.0,9.0,10.0,13.0,14.0,23.0,10.0,16.0,9.0,16.0,17.0,15.0,14.0,7.0,17.0,22.0,14.0,18.0,17.0,24.0,21.0,30.0,23.0,30.0,29.0,22.0,41.0,29.0,24.0,29.0,21.0,41.0,26.0,19.0,35.0,24.0,23.0,30.0,21.0,16.0,19.0,18.0,22.0,14.0,15.0,26.0,22.0,28.0,26.0,10.0,25.0,22.0,15.0,10.0,8.0,7.0,6.0,3.0,2.0,0.0,1.0,1.0,0.0,0.0,11.60949868,11.01265823,8.771929825,108,39,102,42,90,39,81,49,102,45,90,26,87,65,189,189,186,24.93403694,23.92405063,25.10121457,106.5395095,104.6632124,102.45901640000001,481,514,490,63.45646438,65.06329114,66.1268556,127.29313929999999,123.77042800000001,102.95918370000001,39.29313929,36.77042802,37.95918367,214.7727273,217.2413793,286.1538462,274,36.14775726,32.78481013,259,27.26045884,202,91.17647059,156.25,190.0,45.50408719,167,19.76047904,76.94300518,297,6.734006733999999,31.42076503,115,14.7826087,7.7844311379999995,3.3670033669999997,7.826086957,15449.182840000001,15264555.92,741.0,722.0,740.0,732.0,748.0,765.0,768.0,784.0,790.0,805.0,799.0,790.0,773.0,769.0,743.0,762.0,756.0,767.0,758.0,729.0,731.0,721.0,701.0,703.0,705.5,708.0,731.0,761.0,898.0,936.0,1023.0,1002.0,1108.0,1216.0,1109.0,1007.0,15.26455593,65.96981953,72.6519661,79.66166887,72.58645486,65.64226333,67.01799938,61.31852143,58.82909428,49.85405428,47.88871706,46.38195852,46.21818042,46.05440231,45.92337983,47.23360465,47.88871706,47.75769458,49.65752056,50.24712173,49.52649808,49.91956552,48.67485195,50.37814421,50.64018917,51.75388027,52.34348144,52.73654888,51.75388027,51.36081282,50.31263297,50.11609925,49.00240815,47.9542283,48.47831823,47.29911589,48.54382947,0,1,2,0,1,14300.87176,2509.966438,1567.929763,8811.184115,1412.958202,43,263,0.008930098000000001,0,0.82,0.46,1.0,1.0
39071,2452,Cantabria,Cantabria,San Pedro del Romeral,233,1488,1255,719.5908009999999,208.33915,0.245168,40.911079,40.665912,17.696422000000002,7.362734,23622.91461,32892.087060000005,9269.172446999999,27966.787669999998,1944.4276989999998,1825.6432,11230.51013,9404.866926,5743.715463,2207.277121,14151.87203,25189.19006,11037.31804,18809.18473,2616.799071,6831.869444,15948.29008,9116.420634,11178.56349,2378.01379,2.0,4.0,5.0,3.0,2.0,3.0,2,5,3,2,2,1,2,1,5,1,3,3,3,2,3,7.0,10.0,6.0,13.0,10.0,2.0,6,6,3,11,6,5,5,4,11,7,5,4,3,8,10,-5,-6,-1,-10,-8,1,-4,-1,0,-9,-4,-4,-3,-3,-6,-6,-2,-1,0,-6,-7,15.26717557,32.5203252,38.46153846,24.19354839,16.52892562,24.3902439,16.260162599999997,40.32258065,25.0,17.85714286,15.7480315,8.333333332999999,18.51851852,9.523809523999999,48.54368932,10.1010101,31.57894737,31.57894737,28.84615385,18.69158879,18.86792453,53.4351145,81.30081301,46.15384615,104.8387097,82.6446281,16.2601626,48.780487799999996,48.38709677,25.0,98.21428571,47.24409449,41.66666667,46.2962963,38.095238099999996,106.79611650000001,70.70707071,51.54639175,42.10526316,28.84615385,74.76635514,94.33962264,-38.16793893,-48.7804878,-7.692307692,-80.64516129,-66.11570248,8.130081301,-32.520325199999995,-8.064516129,0.0,-80.35714286,-31.49606299,-33.33333333,-27.77777778,-28.57142857,-58.25242718,-60.60606061,-20.6185567,-10.52631579,0.0,-56.07476636,-66.03773585,7,7,0,12,12,0,-5,-5,0,13,10,3,19,19,0,-6,-9,3,9,9,0,23,23,0,-14,-14,0,9,8,1,21,21,0,-12,-13,1,15,15,0,13,13,0,2,2,0,17,17,0,5,5,0,12,12,0,51,51,0,10,10,0,41,41,0,20,19,1,48,47,1,-28,-28,0,29,26,3,25,25,0,4,1,3,16.0,12.0,18.0,9.0,11.0,16.0,10.0,19.0,26.0,15.0,22.0,43.0,20.0,24.0,49.0,19.0,29.0,33.0,27.0,31.0,34.0,24.0,44.0,26.0,33.0,25.0,31.0,33.0,34.0,41.0,33.0,40.0,43.0,33.0,38.0,40.0,43.0,42.0,31.0,35.0,37.0,51.0,42.0,42.0,34.0,29.0,32.0,31.0,29.0,17.0,22.0,16.0,16.0,15.0,6.0,6.0,9.0,2.0,0.0,3.0,0.0,1.0,0.0,8.0,8.0,12.0,5.0,6.0,6.0,7.0,10.0,14.0,8.0,11.0,31.0,13.0,15.0,23.0,9.0,17.0,16.0,15.0,14.0,19.0,15.0,26.0,15.0,16.0,17.0,16.0,19.0,18.0,25.0,21.0,23.0,26.0,16.0,19.0,20.0,27.0,23.0,17.0,20.0,23.0,32.0,25.0,20.0,16.0,16.0,17.0,14.0,15.0,10.0,6.0,5.0,4.0,5.0,3.0,1.0,0.0,1.0,0.0,1.0,0.0,0.0,0.0,8.0,4.0,6.0,4.0,5.0,10.0,3.0,9.0,12.0,7.0,11.0,12.0,7.0,9.0,26.0,10.0,12.0,17.0,12.0,17.0,15.0,9.0,18.0,11.0,17.0,8.0,15.0,14.0,16.0,16.0,12.0,17.0,17.0,17.0,19.0,20.0,16.0,19.0,14.0,15.0,14.0,19.0,17.0,22.0,18.0,13.0,15.0,17.0,14.0,7.0,16.0,11.0,12.0,10.0,3.0,5.0,9.0,1.0,0.0,2.0,0.0,1.0,0.0,10.06711409,8.045977011,7.383966245,91,28,76,18,74,15,74,32,76,24,74,20,42,35,165,151,159,27.68456376,28.92720307,33.5443038,111.34751770000001,117.5,125.7142857,371,329,280,62.24832215,63.02681992,59.07172996,104.4743935,87.89665653,91.78571429,44.47439353,45.89665653,56.78571429,275.0,359.5238095,454.2857143,229,38.42281879,25.67049808,134,24.6835443,117,72.09302326,190.9090909,286.6666667,42.55319149,120,15.0,72.91666667,175,6.857142857,36.19047619,76,21.05263158,5.0,2.285714286,10.52631579,36338.93805,57248422.6,474.0,474.0,507.0,466.0,452.0,453.0,461.0,477.0,488.0,503.0,528.0,522.0,547.0,548.0,565.0,561.0,573.0,588.0,596.0,618.0,626.0,645.0,657.0,668.0,680.5,693.0,781.0,1015.0,1011.0,1165.0,1195.0,1265.0,1202.0,1223.0,1132.0,1078.0,57.24842072,18.83021377,19.77347123,21.36303473,20.99621238,22.09667942,20.87393827,20.34990635,17.65987581,17.72974673,13.64229773,12.10513742,11.88679079,11.66844415,11.47629912,11.26668635,10.93479946,10.79505762,10.41076754,10.27102569,10.00900973,9.799396961,9.869267884,9.572316461,9.554848731,9.118155461,9.222961846,8.786268577000001,8.524252615,8.332107577,8.052623883999999,7.912882037999999,7.895414307999999,8.139962537999999,8.856139500000001,8.279704384,8.279704384,0,1,0,0,1,33908.849160000005,5893.787401,6487.522015,10884.92202,2958.9843379999998,1,10,0.004702424,0,0.0,0.0,0.89,0.94
39072,2453,Cantabria,Cantabria,San Roque de Riomiera,324,1544,1220,775.958573,242.635489,0.6129,45.409283,44.796383,17.207588,7.417466,13777.138480000001,29615.834310000002,15838.69583,21721.07158,4039.8457590000003,7157.512404000001,17792.74186,10635.229459999999,13867.5504,2515.014012,7647.42218,23489.3396,15841.917419999998,15537.042580000001,4045.025511,7259.395562999999,16784.51611,9525.120551,12699.76395,2203.915752,3.0,3.0,2.0,3.0,1.0,6.0,2,1,1,1,4,1,2,0,3,1,0,1,0,2,3,4.0,5.0,6.0,6.0,0.0,9.0,6,5,3,8,2,9,3,4,10,3,6,5,6,13,5,-1,-2,-4,-3,1,-3,-4,-4,-2,-7,2,-8,-1,-4,-7,-2,-6,-4,-6,-11,-2,4.608294931,4.731861199,3.28407225,4.926108374,1.715265866,10.45296167,3.4071550260000003,1.7421602790000001,1.798561151,1.8181818180000002,7.575757576,1.9230769230000002,3.921568627,0.0,6.43776824,2.222222222,0.0,2.433090024,0.0,5.221932115,7.692307692000001,6.144393241,7.886435331,9.852216749,9.852216749,0,15.67944251,10.22146508,8.710801394,5.395683452999999,14.54545455,3.787878788,17.30769231,5.882352941000001,8.350730689,21.45922747,6.666666667,14.11764706,12.16545012,14.85148515,33.94255875,12.82051282,-1.53609831,-3.154574132,-6.568144499,-4.926108374,1.715265866,-5.226480836,-6.8143100510000005,-6.968641115,-3.597122302,-12.72727273,3.787878788,-15.38461538,-1.960784314,-8.350730689,-15.02145923,-4.444444444,-14.11764706,-9.732360097,-14.85148515,-28.72062663,-5.128205128,1,1,0,10,10,0,-9,-9,0,16,16,0,20,20,0,-4,-4,0,16,14,2,20,20,0,-4,-6,2,9,9,0,16,16,0,-7,-7,0,13,13,0,13,12,1,0,1,-1,7,7,0,15,15,0,-8,-8,0,11,11,0,20,19,1,-9,-8,-1,12,11,1,19,19,0,-7,-8,1,5,4,1,10,10,0,-5,-6,1,4.0,11.0,9.0,4.0,13.0,17.0,8.0,23.0,17.0,19.0,19.0,26.0,15.0,18.0,41.0,18.0,27.0,35.0,15.0,26.0,23.0,20.0,28.0,37.0,29.0,35.0,38.0,26.0,46.0,29.0,30.0,28.0,27.0,36.0,31.0,26.0,29.0,26.0,32.0,22.0,27.0,34.0,20.0,23.0,34.0,20.0,35.0,26.0,9.0,17.0,7.0,5.0,3.0,3.0,7.0,1.0,4.0,0.0,1.0,1.0,1.0,0.0,0.0,2.0,6.0,6.0,3.0,9.0,5.0,4.0,10.0,10.0,13.0,10.0,11.0,6.0,10.0,18.0,10.0,10.0,21.0,8.0,14.0,17.0,6.0,16.0,21.0,22.0,21.0,23.0,17.0,28.0,16.0,16.0,15.0,22.0,22.0,24.0,15.0,15.0,19.0,20.0,16.0,17.0,17.0,16.0,13.0,17.0,10.0,16.0,18.0,6.0,8.0,6.0,2.0,3.0,2.0,2.0,1.0,0.0,0.0,0.0,0.0,1.0,0.0,0.0,2.0,5.0,3.0,1.0,4.0,12.0,4.0,13.0,7.0,6.0,9.0,15.0,9.0,8.0,23.0,8.0,17.0,14.0,7.0,12.0,6.0,14.0,12.0,16.0,7.0,14.0,15.0,9.0,18.0,13.0,14.0,13.0,5.0,14.0,7.0,11.0,14.0,7.0,12.0,6.0,10.0,17.0,4.0,10.0,17.0,10.0,19.0,8.0,3.0,9.0,1.0,3.0,0.0,1.0,5.0,0.0,4.0,0.0,1.0,1.0,0.0,0.0,0.0,9.227467811,10.73059361,4.747774481,49,22,49,22,31,7,60,21,49,25,31,9,47,16,109,107,84,23.39055794,24.42922374,24.92581602,131.84079599999998,132.9787234,140.71428569999998,314,284,237,67.38197425,64.84018265,70.3264095,77.7133758,84.67605634,51.44303797,34.713375799999994,37.67605634,35.44303797,253.4883721,227.65957450000002,525.0,120,25.75107296,30.82191781,135,26.70623145,90,123.07692309999999,136.84210530000001,152.63157890000002,55.2238806,111,8.108108108,81.38297872,153,7.1895424839999995,46.42857143,65,6.153846154,2.702702703,3.2679738560000002,3.076923077,39679.767439999996,35547807.92,337.0,345.0,356.0,370.0,380.0,386.0,394.0,393.0,398.0,412.0,437.0,438.0,446.0,453.0,456.0,461.0,454.0,461.0,466.0,482.0,499.0,528.0,536.0,527.0,549.5,572.0,613.0,612.0,998.0,977.0,1117.0,977.0,845.0,821.0,801.0,912.0,35.5478096,25.655589199999998,22.53303393,23.0956565,23.77080359,27.48411255,31.42247054,27.48411255,28.07486625,17.21625065,17.24438177,16.09100551,15.45805511,14.82510472,15.07828488,14.85323585,14.03743312,13.55920394,13.10910588,12.96845024,12.77153234,12.96845024,12.827794599999999,12.74340121,12.54648331,12.32143429,12.29330316,11.59002494,11.19618915,11.055533500000001,11.08366463,10.8586156,10.68982883,10.40851755,10.01468175,9.705239335,9.480190307,0,0,0,0,1,27725.562360000004,3260.3526829999996,7105.94272,8142.94174,3944.366247,18,121,0.022040481,0,0.0,0.0,1.0,0.79
39073,2454,Cantabria,Cantabria,Santa Cruz de Bezana,0,181,181,46.649704,31.553597999999997,0.0,22.059904,22.059904,3.296098,3.0309220000000003,1115.017497,5339.028902,4224.0114060000005,3285.4751300000003,971.7570820000001,36.136074,4418.186028,4382.049954,1829.369852,958.882464,16.02252,4275.898377,4259.875857,1774.7986010000002,880.468098,20.465398,2903.206446,2882.741048,1249.175553,588.908167,98.0,90.0,90.0,107.0,109.0,104.0,119,118,128,127,105,136,116,107,119,124,110,111,111,85,89,77.0,55.0,66.0,71.0,66.0,73.0,67,69,75,80,76,70,77,70,68,82,89,80,87,67,89,21,35,24,36,43,31,52,49,53,47,29,66,39,37,51,42,21,31,24,18,0,302.4691358,284.8101266,301.0033445,378.0918728,394.9275362,379.5620438,454.1984733,460.9375,479.40074910000004,472.1189591,413.3858268,527.1317829,465.86345379999995,433.1983806,479.8387097,484.375,468.0851063999999,472.3404255,466.3865546,367.965368,429.8245614,237.654321,174.0506329,220.735786,250.8833922,239.1304348,266.4233577,255.72519080000004,269.53125,280.8988764,297.3977695,299.2125984,271.3178295,309.2369478,283.4008097,274.1935484,320.3125,357.42971889999995,340.42553189999995,365.5462185,290.04329,390.3508772,64.81481481,110.7594937,80.26755853,127.2084806,155.7971014,113.1386861,198.47328240000002,191.40625,198.5018727,174.7211896,114.1732283,255.81395350000003,156.626506,149.7975709,205.6451613,164.0625,84.33734940000001,131.9148936,100.84033609999999,77.92207792,0.0,776,740,36,599,570,29,177,170,7,685,654,31,596,539,57,89,115,-26,703,680,23,680,637,43,23,43,-20,732,694,38,635,580,55,97,114,-17,731,673,58,601,570,31,130,103,27,734,690,44,623,580,43,111,110,1,756,702,54,657,604,53,99,98,1,695,638,57,723,689,34,-28,-51,23,787,733,54,561,533,28,226,200,26,541.0,680.0,532.0,696.0,634.0,503.0,768.0,614.0,545.0,720.0,608.0,608.0,610.0,650.0,739.0,578.0,793.0,813.0,710.0,1018.0,758.0,995.0,993.0,727.0,1188.0,911.0,985.0,1143.0,1027.0,843.0,981.0,1035.0,663.0,1037.0,754.0,504.0,1026.0,629.0,292.0,809.0,392.0,273.0,640.0,246.0,249.0,368.0,257.0,220.0,226.0,195.0,155.0,157.0,103.0,102.0,75.0,57.0,40.0,19.0,7.0,9.0,5.0,4.0,2.0,285.0,322.0,257.0,378.0,315.0,277.0,391.0,319.0,246.0,366.0,304.0,326.0,315.0,302.0,373.0,305.0,415.0,394.0,314.0,513.0,366.0,478.0,459.0,336.0,585.0,454.0,474.0,538.0,487.0,435.0,489.0,525.0,339.0,482.0,394.0,282.0,511.0,321.0,157.0,416.0,206.0,127.0,309.0,114.0,119.0,170.0,115.0,93.0,89.0,71.0,58.0,54.0,38.0,28.0,20.0,14.0,9.0,1.0,2.0,2.0,2.0,0.0,0.0,256.0,358.0,275.0,318.0,319.0,226.0,377.0,295.0,299.0,354.0,304.0,282.0,295.0,348.0,366.0,273.0,378.0,419.0,396.0,505.0,392.0,517.0,534.0,391.0,603.0,457.0,511.0,605.0,540.0,408.0,492.0,510.0,324.0,555.0,360.0,222.0,515.0,308.0,135.0,393.0,186.0,146.0,331.0,132.0,130.0,198.0,142.0,127.0,137.0,124.0,97.0,103.0,65.0,74.0,55.0,43.0,31.0,18.0,5.0,7.0,3.0,4.0,2.0,16.5237398,16.61066598,15.08426121,614,800,701,972,1238,951,436,780,701,956,1238,1054,1928,2005,1050,1261,2299,10.98096633,10.86413371,17.29611797,96.58717105,96.16359642,95.6432146,6932,8418,8988,72.49529387,72.52520031,67.61962082,1595.147144,1942.9798050000002,2030.5785489999998,15.14714368,14.97980518,25.57854918,66.4556962,65.40456432,114.6633416,941,9.84103744,34.02257259,3949,30.3641288,4036,48.02631579,103.4539474,142.5,46.64884868,2269,23.44645218,84.04596924,4973,13.67383873,34.78068884,2363,22.89462548,12.1198766,7.1988739189999995,10.83368599,22676.17861,17305547.51,13292.0,13088.0,13095.0,12964.0,12818.0,12679.0,12560.0,12500.0,12369.0,12154.0,11776.0,11607.0,11279.0,10831.0,10463.0,10314.0,10012.0,9799.0,9562.0,8828.0,8269.0,7890.0,7617.0,7239.0,7142.5,7046.0,5280.0,3651.0,3397.0,3484.0,3124.0,2939.0,2916.0,2548.0,2298.0,2052.0,17.30554771,118.57469259999999,132.7897873,147.2360218,168.5008789,169.82993249999998,180.52014599999998,201.32272360000002,196.295434,210.9728083,305.1044721,407.1526724,412.728919,418.3051655,440.14787199999995,455.92315999999994,477.8236515,510.1254318,552.5395762,566.2346065,578.5427983,595.9938495,604.6038053,625.8686624,651.7563146000001,670.7097742000001,680.4754287000001,702.3181352000001,714.7418968999999,722.3117238,725.77882,732.6552276000001,740.687334,749.1239349,756.6937618,756.2892672,768.0773946,1,1,8,1,1,2573.177405,2337.2930149999997,966.328668,2145.260429,1896.1877149999998,60,256,0.01025715,0,1.0,0.55,1.0,1.0
39074,2455,Cantabria,Cantabria,Santa Mar√≠a de Cay√≥n,57,839,782,233.83369199999999,148.915669,0.0,41.49762,41.49762,10.567905,7.479365,7997.604265000001,14568.02687,6570.4226,11747.61891,1432.804372,19.575196,7856.00425,7836.429054000001,3076.701335,2035.022666,14.133467999999999,7828.9719319999995,7814.838464,3200.912116,2008.1496489999997,4055.806642,11100.88824,7045.081601999999,7910.23601,1344.6695869999999,61.0,55.0,56.0,70.0,77.0,81.0,85,95,105,118,103,119,114,128,100,67,99,55,71,65,48,62.0,52.0,48.0,68.0,41.0,63.0,62,66,58,51,68,62,70,67,56,70,87,69,75,76,87,-1,3,8,2,36,18,23,29,47,67,35,57,44,61,44,-3,12,-14,-4,-11,-39,300.4926108,273.6318408,282.8282828,336.5384615,381.1881188,415.3846154,442.70833330000005,458.93719810000005,549.7382199,570.0483092000001,522.8426396000001,619.7916667000001,644.0677966,748.5380117000001,561.7977528,411.04294480000004,575.5813952999999,319.7674419,422.6190476,401.23456789999994,344.6327684,305.4187192,258.7064677,242.4242424,326.9230769,202.970297,323.0769231,322.9166667,318.8405797,303.6649215,246.3768116,345.177665,322.9166667,395.48022599999996,391.8128655,314.6067416,429.4478528,511.76470589999997,401.16279069999996,446.42857139999995,469.1358025,491.5254237,-4.926108374,14.92537313,40.4040404,9.615384615,178.2178218,92.30769231,119.79166670000001,140.0966184,246.07329840000003,323.6714976,177.6649746,296.875,248.58757059999996,356.7251462,247.19101119999996,-18.40490798,70.58823529,-81.39534884,-23.80952381,-67.90123457,-220.33898309999998,499,441,58,448,413,35,51,28,23,466,419,47,407,382,25,59,37,22,470,420,50,505,448,57,-35,-28,-7,386,353,33,468,395,73,-82,-42,-40,446,394,52,656,370,286,-210,24,-234,450,394,56,410,397,13,40,-3,43,525,468,57,389,373,16,136,95,41,456,397,59,399,380,19,57,17,40,464,424,40,358,343,15,106,81,25,359.0,534.0,253.0,531.0,432.0,290.0,544.0,363.0,359.0,450.0,395.0,352.0,387.0,483.0,454.0,394.0,684.0,504.0,503.0,911.0,587.0,727.0,849.0,657.0,940.0,823.0,517.0,840.0,729.0,407.0,779.0,529.0,340.0,671.0,411.0,298.0,512.0,372.0,285.0,418.0,297.0,390.0,329.0,319.0,329.0,264.0,324.0,214.0,239.0,198.0,148.0,218.0,122.0,78.0,83.0,26.0,37.0,16.0,12.0,4.0,1.0,1.0,2.0,179.0,299.0,133.0,269.0,224.0,141.0,280.0,177.0,167.0,230.0,181.0,188.0,195.0,235.0,247.0,172.0,365.0,257.0,239.0,481.0,299.0,385.0,454.0,339.0,465.0,436.0,274.0,448.0,430.0,216.0,400.0,303.0,168.0,371.0,217.0,145.0,271.0,185.0,123.0,217.0,131.0,201.0,154.0,150.0,159.0,105.0,144.0,99.0,93.0,86.0,65.0,82.0,47.0,25.0,27.0,6.0,9.0,4.0,3.0,0.0,1.0,0.0,0.0,180.0,235.0,120.0,262.0,208.0,149.0,264.0,186.0,192.0,220.0,214.0,164.0,192.0,248.0,207.0,222.0,319.0,247.0,264.0,430.0,288.0,342.0,395.0,318.0,475.0,387.0,243.0,392.0,299.0,191.0,379.0,226.0,172.0,300.0,194.0,153.0,241.0,187.0,162.0,201.0,166.0,189.0,175.0,169.0,170.0,159.0,180.0,115.0,146.0,112.0,83.0,136.0,75.0,53.0,56.0,20.0,28.0,12.0,9.0,4.0,0.0,1.0,2.0,13.86625673,15.07828455,15.57848995,644,461,732,629,885,706,558,441,732,700,885,728,1329,1434,1202,1299,1568,18.47809377,14.73791695,17.03422053,100.1538462,106.9014085,99.32871373,4401,6186,6203,67.6556495,70.1837985,67.38728952,929.3119746,1349.9990300000002,1459.278091,27.31197455,20.99903007,25.27809125,133.2594235,97.74266366,109.3444909,2877,44.22751729,37.57658271,3312,32.69961977,3010,80.96590909,94.17721519,113.7777778,49.35384615,1604,15.77306733,97.30046948,4145,12.88299156,36.50931139,1686,21.29300119,7.481296757999999,5.6694813029999995,10.67615658,37020.23972,47611782.16,9205.0,9167.0,9159.0,9060.0,9095.0,9078.0,9090.0,9097.0,9060.0,9123.0,9005.0,8814.0,8526.0,8148.0,7556.0,7377.0,7107.0,6614.0,6505.0,6465.0,6434.0,6354.0,6324.0,6265.0,6230.5,6196.0,5982.0,5854.0,5576.0,4995.0,4573.0,4310.0,3859.0,3515.0,3290.0,2845.0,47.61178207,59.75411707,69.10054312,73.82626415,81.05136653,90.5238118,96.04765461,104.91100690000002,117.1138688,122.9527597,125.64116990000001,130.1358557,130.8604662,131.5850768,132.8242659,133.454362,135.13461840000002,135.7857177,136.6258459,138.91519519999997,149.2697751,154.9406403,158.7002139,171.13411100000002,179.07332240000002,185.12224530000003,189.1338574,191.6122355,190.28903359999998,191.06615219999998,190.9191298,190.6670913,191.0241458,190.28903359999998,192.3683509,192.5363765,193.3344983,0,0,10,1,3,16490.042390000002,8506.308196,2986.876929,3952.673641,1944.2942899999998,23,117,0.001117844,0,0.98,0.81,1.0,1.0
39078,2457,Cantabria,Cantabria,Santiurde de Toranzo,74,873,799,342.044524,195.499861,0.0,41.200611,41.200611,12.914415,7.9298839999999995,9532.560689,22878.65535,13346.094659999999,16476.754719999997,3491.266024,108.91654399999999,3959.1295909999994,3850.2130469999997,1700.1306829999999,798.473073,1874.5116289999999,14856.53815,12982.02652,9150.625404,3432.7993149999998,6572.455269,14320.600080000002,7748.144809,11149.985009999999,1721.696607,7.0,4.0,3.0,15.0,7.0,9.0,6,6,6,8,7,11,16,7,11,11,15,12,14,12,13,14.0,21.0,19.0,23.0,16.0,15.0,23,18,25,17,24,24,34,33,18,19,22,20,20,27,13,-7,-17,-16,-8,-9,-6,-17,-12,-19,-9,-17,-13,-18,-26,-7,-8,-7,-8,-6,-15,0,0.107319167,0.060944951,0.045749142,0.228522677,0.106632544,0.136109977,0.09072352,0.090719405,0.089992801,0.120676391,0.10606382,0.167874857,0.24479055100000002,0.107715508,0.170746473,0.17233005899999998,0.240426998,0.19234159899999997,0.226438287,0.195420643,0.114776677,0.214638334,0.319960995,0.289744567,0.350401438,0.24373153,0.226849961,0.34777349399999996,0.272158215,0.374970002,0.256437331,0.363647383,0.366272415,0.520179921,0.50780168,0.279403319,0.29766101100000003,0.348007656,0.320569331,0.323483268,0.43969644700000005,0.21315668699999998,-0.107319167,-0.259016044,-0.243995425,-0.121878761,-0.137098985,-0.090739985,-0.25704997399999996,-0.18143881,-0.284977202,-0.13576094,-0.257583563,-0.198397558,-0.27538937,-0.400086172,-0.108656846,-0.125330952,-0.11072970900000001,-0.12822773199999998,-0.09704498,-0.24427580399999999,0.0,46,46,0,51,51,0,-5,-5,0,76,75,1,59,46,13,17,29,-12,93,90,3,52,52,0,41,38,3,57,57,0,53,51,2,4,6,-2,65,59,6,48,47,1,17,12,5,74,73,1,57,56,1,17,17,0,62,61,1,50,50,0,12,11,1,91,90,1,61,59,2,30,31,-1,115,111,4,64,64,0,51,47,4,73.0,45.0,15.0,77.0,36.0,22.0,50.0,50.0,73.0,54.0,69.0,95.0,51.0,92.0,109.0,64.0,100.0,89.0,117.0,105.0,89.0,131.0,98.0,101.0,112.0,117.0,98.0,136.0,116.0,94.0,135.0,117.0,94.0,126.0,104.0,93.0,141.0,104.0,78.0,109.0,88.0,102.0,110.0,85.0,97.0,84.0,88.0,96.0,55.0,62.0,67.0,39.0,53.0,32.0,25.0,16.0,11.0,6.0,6.0,5.0,0.0,1.0,1.0,44.0,21.0,10.0,42.0,15.0,13.0,26.0,32.0,27.0,27.0,33.0,50.0,27.0,42.0,53.0,28.0,57.0,55.0,54.0,52.0,46.0,78.0,53.0,53.0,62.0,64.0,56.0,73.0,61.0,46.0,77.0,60.0,47.0,63.0,50.0,41.0,78.0,59.0,41.0,51.0,42.0,53.0,67.0,45.0,49.0,40.0,37.0,50.0,24.0,33.0,28.0,21.0,21.0,10.0,9.0,6.0,4.0,3.0,0.0,0.0,0.0,0.0,1.0,29.0,24.0,5.0,35.0,21.0,9.0,24.0,18.0,46.0,27.0,36.0,45.0,24.0,50.0,56.0,36.0,43.0,34.0,63.0,53.0,43.0,53.0,45.0,48.0,50.0,53.0,42.0,63.0,55.0,48.0,58.0,57.0,47.0,63.0,54.0,52.0,63.0,45.0,37.0,58.0,46.0,49.0,43.0,40.0,48.0,44.0,51.0,46.0,31.0,29.0,39.0,18.0,32.0,22.0,16.0,10.0,7.0,3.0,6.0,5.0,0.0,1.0,0.0,7.529089665,8.440721649,11.79941003,216,60,215,63,213,88,195,50,215,68,213,112,131,200,411,399,428,28.13141684,25.70876289,25.25073746,100.6868132,101.82054620000001,111.6104869,940,1022,1067,64.3394935,65.85051546,62.94985251,153.7234043,170.04109590000002,240.11246490000002,43.72340426,39.04109589,40.11246485,373.63636360000004,304.5801527,214.0,42018,2875.975359,28.09278351,436,29.26253687,496,82.10526316,150.7246377,261.1111111,42.99450549,313,4.792332268,75.5526658,581,7.745266781000001,34.45692884,276,26.44927536,1.5974440890000001,4.13080895,10.50724638,36673.325110000005,36303922.11,1695.0,1646.0,1629.0,1623.0,1610.0,1602.0,1619.0,1581.0,1590.0,1604.0,1581.0,1552.0,1512.0,1485.0,1351.0,1359.0,1366.0,1406.0,1461.0,1546.0,1615.0,1627.0,1651.0,1675.0,1685.0,1695.0,1803.0,1888.0,2034.0,2189.0,2375.0,2506.0,2358.0,2412.0,2168.0,2037.0,36.30392075,56.109642099999995,59.71806779,66.43910494,64.95166229,69.02835695,65.41993127,60.2965177,56.027006400000005,52.005402200000006,49.664057299999996,46.689172,46.41371966,46.13826732,45.4771817,44.81609607,44.48555326,42.5849321,40.24358719,38.72859931,37.62678994,37.4339733,37.21361143,40.90467281,41.64839414,42.75020351,43.5490153,44.18255569,43.79692241,43.5490153,44.5957342,44.12746522,44.34782709,44.70591514,44.87118654,45.33945552,46.689172,0,1,0,0,2,19889.92565,7195.889319,6967.497256000001,4179.995172,1795.018666,11,82,0.020259571,0,0.83,0.15,1.0,1.0
39079,2458,Cantabria,Cantabria,Santo√±a,-4,366,370,95.757667,99.83881,0.0,55.53440500000001,55.53440500000001,11.509911,11.332966,50.453342,3180.20252,3129.749178,1640.6103779999999,715.8352219999999,3238.880618,6692.044231,3453.163612,4989.695193,705.7592530000001,4282.356146,7486.84108,3204.484934,5838.318293,717.218485,3131.25589,6914.990312999999,3783.734423,5200.877014,800.599202,89.0,103.0,98.0,102.0,103.0,115.0,94,113,87,122,94,98,76,98,76,92,78,83,68,82,67,104.0,107.0,121.0,148.0,115.0,122.0,116,128,114,113,94,129,115,116,133,132,120,109,118,131,159,-15,-4,-23,-46,-12,-7,-22,-15,-27,9,0,-31,-39,-18,-57,-40,-42,-26,-50,-49,-92,89.44723618,104.3566363,98,99.22178988,97.53787879,109.2117759,89.35361217,105.90440490000002,81.84383819,115.85944920000001,89.09952607,92.80303029999999,74.14634146,95.14563107,75.84830339,91.08910891,75.0,79.80769231,64.76190476,78.31900669,85.08604207,104.5226131,108.4093212,121,143.9688716,108.9015152,115.8594492,110.2661597,119.96251170000001,107.24365,107.3124406,89.09952607,122.1590909,112.195122,112.6213592,132.7345309,130.6930693,118.57707509999999,104.8076923,112.3809524,125.11938870000002,152.00764819999998,-15.07537688,-4.052684904,-23,-44.74708171,-11.36363636,-6.647673314,-20.91254753,-14.05810684,-25.39981185,8.547008547,0.0,-29.35606061,-38.04878049,-17.47572816,-56.88622754,-39.6039604,-41.50197628,-25.0,-47.61904762,-46.80038204,-87.9541109,394,331,63,423,397,26,-29,-66,37,393,351,42,392,370,22,1,-19,20,387,352,35,442,417,25,-55,-65,10,384,340,44,354,317,37,30,23,7,349,296,53,365,325,40,-16,-29,13,470,389,81,538,362,176,-68,27,-95,428,315,113,390,366,24,38,-51,89,498,381,117,450,402,48,48,-21,69,435,379,56,352,338,14,83,41,42,400.0,543.0,482.0,460.0,506.0,487.0,506.0,487.0,625.0,537.0,594.0,709.0,491.0,684.0,902.0,543.0,842.0,963.0,615.0,950.0,893.0,732.0,824.0,937.0,859.0,916.0,975.0,802.0,917.0,847.0,839.0,873.0,764.0,856.0,717.0,675.0,799.0,687.0,471.0,717.0,542.0,504.0,627.0,423.0,483.0,498.0,435.0,426.0,308.0,348.0,247.0,252.0,198.0,156.0,119.0,67.0,74.0,48.0,27.0,23.0,3.0,4.0,3.0,205.0,291.0,263.0,231.0,263.0,247.0,262.0,258.0,331.0,278.0,315.0,367.0,261.0,348.0,482.0,279.0,447.0,503.0,322.0,502.0,477.0,391.0,432.0,488.0,438.0,476.0,500.0,401.0,451.0,445.0,403.0,438.0,424.0,395.0,385.0,342.0,386.0,342.0,236.0,352.0,263.0,229.0,288.0,187.0,199.0,237.0,156.0,157.0,111.0,121.0,74.0,84.0,46.0,44.0,30.0,14.0,12.0,10.0,4.0,6.0,0.0,0.0,2.0,195.0,252.0,219.0,229.0,243.0,240.0,244.0,229.0,294.0,259.0,279.0,342.0,230.0,336.0,420.0,264.0,395.0,460.0,293.0,448.0,416.0,341.0,392.0,449.0,421.0,440.0,475.0,401.0,466.0,402.0,436.0,435.0,340.0,461.0,332.0,333.0,413.0,345.0,235.0,365.0,279.0,275.0,339.0,236.0,284.0,261.0,279.0,269.0,197.0,227.0,173.0,168.0,152.0,112.0,89.0,53.0,62.0,38.0,23.0,17.0,3.0,4.0,1.0,13.68710287,13.25966851,12.40577604,1193,753,1253,724,1460,668,723,841,1253,812,1460,698,1536,1366,1916,2044,2572,16.45200069,17.64502762,23.35845972,100.1718804,98.18648417,94.98848946,8136,8004,7073,69.86089645,69.09530387,64.23576424,1617.5496560000001,1561.537231,1402.363636,23.54965585,25.53723138,36.36363636,120.20075279999999,133.0729167,188.2869693,1135,9.74583548,31.13777624,3607,27.31813641,3008,66.43159379,115.65656570000002,148.78957169999998,48.41870058,2817,17.11040114,82.29255774,4810,11.28898129,34.86807154,1969,20.31488065,7.774227902000001,5.239085239,9.903504317000001,15355.32768,11339046.34,11011.0,11019.0,11024.0,11050.0,11004.0,11085.0,11088.0,11222.0,11382.0,11451.0,11465.0,11584.0,11569.0,11601.0,11574.0,11534.0,11592.0,11521.0,11646.0,11593.0,11567.0,11556.0,11657.0,11657.0,11750.0,11843.0,10929.0,11003.0,10633.0,9082.0,8938.0,11136.0,7024.0,7327.0,6315.0,4339.0,11.33904648,382.66004189999995,556.9251357999999,646.1742628999999,619.4524392999999,982.0931611,788.2497013,800.9491819,937.7331700999999,970.3637798000001,963.8376579,1044.444083,1036.242335,1028.040587,1028.040587,1019.133313,1020.1034119999999,1022.396374,1027.070488,1016.046633,1022.308183,1017.193114,1020.7207480000001,1023.1019,1020.2797939999999,1021.602656,1011.1079470000001,1009.873275,1003.7881070000001,989.6775731,977.8600008999999,977.5954284,970.4519706,974.5087491,972.2157874,971.7748332,971.0693064999999,0,1,0,1,1,4644.5537380000005,2260.576607,4850.427335,1752.8067219999998,1581.62931,71,368,0.00010205,0,0.81,0.09,1.0,1.0
39080,2459,Cantabria,Cantabria,San Vicente de la Barquera,-10,548,558,78.663712,84.316789,0.0,33.212456,33.212456,7.454801,5.557918,23599.92195,32439.07705,8839.155106999999,28276.63182,2102.361341,5.161329,6923.843937000001,6918.682609,2568.7410670000004,1607.851262,33.702976,6578.540639,6544.837663,2870.561859,1239.635798,5.090655,6730.269404000001,6725.178749,2955.996596,1423.290712,41.0,34.0,29.0,35.0,34.0,44.0,40,27,30,38,42,25,26,25,20,23,31,25,25,23,19,53.0,49.0,37.0,42.0,36.0,35.0,52,32,46,40,33,51,48,58,41,47,40,34,51,53,68,-12,-15,-8,-7,-2,9,-12,-5,-16,-2,9,-26,-22,-33,-21,-24,-9,-9,-26,-30,-49,6.350681537,5.20753561,4.361558129,5.118455689,4.92325514,6.182380216,5.410523467999999,3.50330868,3.750937734,4.617815043999999,5.020920502,2.944987631,3.076558987,2.9232927969999998,2.331002331,2.670692058,3.585887796,2.8918449969999998,2.8682882060000003,2.618993396,4.644839696,8.209417596,7.504977791,5.564746578,6.142146827,5.212858384,4.917802445,7.033680509,4.152069547,5.751437859,4.860857941,3.945008966,6.007774767000001,5.679801207000001,6.782039289,4.778554778999999,5.457501161000001,4.662548083,3.932909196,5.851307939,6.035071737999999,7.70363657,-1.858736059,-2.297442181,-1.203188449,-1.023691138,-0.289603244,1.264577772,-1.62315704,-0.648760867,-2.000500125,-0.24304289699999998,1.075911536,-3.0627871360000003,-2.60324222,-3.858746492,-2.447552448,-2.7868091039999996,-1.0490733190000001,-1.041064199,-2.983019734,-3.416078342,-5.551149881000001,140,123,17,164,155,9,-24,-32,8,146,133,13,168,146,22,-22,-13,-9,126,117,9,169,159,10,-43,-42,-1,156,145,11,183,156,27,-27,-11,-16,149,134,15,154,136,18,-5,-2,-3,165,142,23,175,162,13,-10,-20,10,182,145,37,186,171,15,-4,-26,22,153,122,31,145,139,6,8,-17,25,175,158,17,139,127,12,36,31,5,125.0,183.0,181.0,128.0,162.0,184.0,159.0,187.0,225.0,169.0,219.0,269.0,167.0,265.0,336.0,203.0,295.0,340.0,198.0,341.0,316.0,241.0,302.0,373.0,335.0,388.0,394.0,306.0,346.0,323.0,341.0,352.0,273.0,350.0,314.0,226.0,335.0,243.0,179.0,292.0,208.0,229.0,237.0,177.0,242.0,180.0,226.0,181.0,115.0,166.0,102.0,118.0,96.0,57.0,60.0,32.0,17.0,13.0,5.0,4.0,1.0,1.0,2.0,63.0,93.0,98.0,59.0,87.0,92.0,74.0,98.0,113.0,98.0,98.0,142.0,87.0,140.0,191.0,86.0,168.0,179.0,108.0,173.0,159.0,131.0,158.0,196.0,172.0,198.0,205.0,144.0,169.0,168.0,172.0,193.0,144.0,166.0,170.0,122.0,185.0,121.0,86.0,144.0,106.0,111.0,113.0,84.0,126.0,79.0,113.0,68.0,45.0,64.0,40.0,44.0,30.0,13.0,25.0,9.0,8.0,5.0,1.0,1.0,0.0,0.0,0.0,62.0,90.0,83.0,69.0,75.0,92.0,85.0,89.0,112.0,71.0,121.0,127.0,80.0,125.0,145.0,117.0,127.0,161.0,90.0,168.0,157.0,110.0,144.0,177.0,163.0,190.0,189.0,162.0,177.0,155.0,169.0,159.0,129.0,184.0,144.0,104.0,150.0,122.0,93.0,148.0,102.0,118.0,124.0,93.0,116.0,101.0,113.0,113.0,70.0,102.0,62.0,74.0,66.0,44.0,35.0,23.0,9.0,8.0,4.0,3.0,1.0,1.0,2.0,13.24949472,11.80124224,10.11539406,467,287,504,254,561,216,367,303,504,278,561,196,532,412,834,911,1016,18.72894678,20.20851819,24.94475816,103.24052940000001,101.70022370000001,96.47853353,3029,3065,2645,68.0215585,67.99023957,64.93984778,617.5338396000001,561.7226754,450.4120983,27.53383955,29.72267537,38.4120983,141.35593219999998,171.2406015,246.6019417,3128,70.24477879999999,30.54569654,1377,26.51608151,1080,66.54275093,110.9589041,198.2248521,48.9274304,1072,16.88432836,80.98434004,1810,10.11049724,32.89917993,682,18.32844575,7.742537313,4.972375691,9.090909091,38118.38541,41576366.76,4073.0,4095.0,4124.0,4158.0,4173.0,4196.0,4247.0,4314.0,4344.0,4407.0,4475.0,4508.0,4546.0,4532.0,4557.0,4491.0,4461.0,4464.0,4453.0,4412.0,4440.0,4412.0,4392.0,4417.0,4406.0,4395.0,4349.0,3956.0,4016.0,3673.0,3313.0,3002.0,2996.0,2202.0,1933.0,1769.0,41.57636642,42.54821073,46.49275938,52.96278125,72.06016922,72.20448197,79.68469313,88.34345846,96.59333764,95.15021009,104.60269559999999,105.70909340000001,105.97366670000001,106.23824009999998,105.63693700000002,106.11797949999999,106.79143899999998,106.11797949999999,107.10411670000002,107.36868999999999,107.29653370000001,108.01809740000002,109.60553780000001,109.00423459999999,109.3409644,108.42698359999999,107.6332634,105.9977189,104.4824349,103.76087120000001,102.1493787,100.9227203,100.36952140000001,100.0087395,99.19096724,98.49345559,97.96430882,0,2,2,1,1,25837.74281,4138.362645,3321.128589,3217.011348,2655.9497530000003,156,778,0.002052871,0,1.0,0.06,1.0,1.0
39076,2460,Cantabria,Cantabria,Santillana del Mar,-2,284,286,94.61544,53.473131,0.122584,27.538079999999997,27.415496,6.442407,4.417719,1235.467878,9768.285147,8532.817269,5906.95703,2023.3714300000001,389.859868,7172.241515000001,6782.381647,3483.8749310000003,1642.624771,427.338891,7489.596919,7062.2580290000005,4031.039607,1652.277052,488.41282,7132.294319,6643.881499,3389.526511,1606.779126,28.0,33.0,22.0,29.0,31.0,38.0,45,24,34,27,33,31,42,33,32,33,37,39,20,29,27,39.0,35.0,37.0,39.0,42.0,36.0,45,41,50,40,32,44,46,46,44,49,38,44,30,49,42,-11,-2,-15,-10,-11,2,0,-17,-16,-13,1,-13,-4,-13,-12,-16,-1,-5,-10,-20,-15,189.1891892,230.7692308,166.6666667,226.5625,240.3100775,314.0495868,387.9310345,206.8965517,303.57142860000005,257.1428571,314.2857143,300.9708738,415.84158419999994,343.75,336.8421053,370.7865169,425.2873563,448.27586210000004,243.90243900000002,376.62337660000003,394.3661972,263.5135135,244.7552448,280.3030303,304.6875,325.5813953,297.5206612,387.9310345,353.44827589999994,446.42857139999995,380.952381,304.76190479999997,427.18446600000004,455.44554460000006,479.16666669999995,463.1578947,550.5617977999999,426.96629210000003,505.74712639999996,365.8536585,636.3636364,591.5492958,-74.32432432,-13.98601399,-113.6363636,-78.125,-85.27131783,16.52892562,0.0,-146.5517241,-142.8571429,-123.8095238,9.523809523999999,-126.21359220000001,-39.6039604,-135.41666669999998,-126.31578950000001,-179.7752809,-11.23595506,-57.47126437,-121.95121950000001,-259.7402597,-211.2676056,131,116,15,124,122,2,7,-6,13,120,118,2,126,119,7,-6,-1,-5,140,133,7,124,108,16,16,25,-9,142,132,10,136,118,18,6,14,-8,113,99,14,143,129,14,-30,-30,0,164,143,21,139,133,6,25,10,15,198,185,13,151,140,11,47,45,2,183,173,10,143,124,19,40,49,-9,172,163,9,154,145,9,18,18,0,161.0,177.0,148.0,176.0,165.0,128.0,207.0,153.0,173.0,186.0,170.0,225.0,169.0,218.0,293.0,166.0,253.0,320.0,237.0,315.0,261.0,337.0,303.0,300.0,345.0,286.0,301.0,332.0,342.0,304.0,303.0,330.0,262.0,348.0,266.0,218.0,308.0,230.0,173.0,285.0,194.0,238.0,211.0,160.0,236.0,179.0,224.0,177.0,105.0,144.0,110.0,111.0,77.0,58.0,53.0,29.0,28.0,11.0,4.0,3.0,1.0,0.0,0.0,88.0,93.0,79.0,100.0,82.0,72.0,100.0,70.0,82.0,95.0,93.0,116.0,81.0,111.0,149.0,93.0,122.0,160.0,116.0,157.0,128.0,170.0,152.0,159.0,177.0,148.0,133.0,161.0,172.0,155.0,156.0,157.0,137.0,174.0,138.0,101.0,144.0,110.0,91.0,139.0,90.0,106.0,100.0,74.0,113.0,80.0,104.0,68.0,37.0,51.0,49.0,39.0,28.0,18.0,8.0,6.0,7.0,0.0,0.0,1.0,0.0,0.0,0.0,73.0,84.0,69.0,76.0,83.0,56.0,107.0,83.0,91.0,91.0,77.0,109.0,88.0,107.0,144.0,73.0,131.0,160.0,121.0,158.0,133.0,167.0,151.0,141.0,168.0,138.0,168.0,171.0,170.0,149.0,147.0,173.0,125.0,174.0,128.0,117.0,164.0,120.0,82.0,146.0,104.0,132.0,111.0,86.0,123.0,99.0,120.0,109.0,68.0,93.0,61.0,72.0,49.0,40.0,45.0,23.0,21.0,11.0,4.0,2.0,1.0,0.0,0.0,11.34984833,12.25247525,12.8574805,488,216,479,250,553,256,362,233,479,245,553,288,495,544,850,832,956,21.48634985,20.59405941,22.59513117,94.68503937,94.04418828,94.70777727,2657,2713,2731,67.16380182,67.15346535,64.54738832,480.9909673,525.6671581,579.0054925,31.99096726,30.66715813,35.00549249,189.3095768,168.0808081,175.73529409999998,1387,35.06066734,30.84158416,1246,29.56747814,1251,76.88888889,135.2941176,165.5913978,41.58464567,845,17.514792899999996,74.2074928,1545,11.45631068,33.68614818,732,21.99453552,8.165680473,5.4368932039999995,9.972677596,27825.48534,28550218.97,4231.0,4229.0,4207.0,4172.0,4154.0,4184.0,4203.0,4197.0,4215.0,4210.0,4029.0,4040.0,4021.0,4049.0,4007.0,3983.0,4022.0,4006.0,3956.0,3950.0,3926.0,3909.0,3865.0,3860.0,3857.0,3854.0,3839.0,3884.0,3917.0,3703.0,3155.0,2657.0,2624.0,2272.0,1886.0,1623.0,28.55021858,56.8472005,66.05903889999999,79.5790755,91.90822804,93.06408609,110.50703490000002,129.7012837,137.196848,136.04099,134.4648199,134.99020990000002,135.0952879,135.2003659,135.3754959,136.91664,137.512082,138.3527061,138.56286210000002,140.3141622,140.8745782,139.50856409999997,140.3491882,141.82028019999998,140.83955219999999,141.50504619999998,141.1197602,147.4594665,147.63459650000001,147.00412849999998,147.2142845,146.5487904,145.4980104,146.1284784,147.3543885,148.1249605,148.1950125,0,1,0,0,4,3822.7225380000004,6387.691979,2705.452355,3814.197487,1184.110263,118,499,0.0035447770000000003,0,0.95,0.0,1.0,1.0
39077,2461,Cantabria,Cantabria,Santiurde de Reinosa,560,1246,686,870.321201,141.249612,0.27410500000000004,42.261524,41.987419,15.83935,7.453367,5218.700028,11242.10885,6023.408820000001,8409.78617,1384.936716,20.74592,5651.381956,5630.636036,1973.8359269999999,1266.860257,31.771342999999998,4027.5293009999996,3995.757957,1583.653168,939.0462060000001,16.756299,5371.432432,5354.676134,2254.005725,1080.865168,0.0,2.0,0.0,0.0,0.0,3.0,0,0,2,1,1,2,1,1,0,1,4,2,0,2,2,5.0,9.0,8.0,7.0,12.0,13.0,5,11,16,15,10,8,7,5,14,8,13,7,15,9,19,-5,-7,-8,-7,-12,-10,-5,-11,-14,-14,-9,-6,-6,-4,-14,-7,-9,-5,-15,-7,-17,0,6.944444444,0,0,0,11.85770751,0.0,0.0,8.474576271,4.366812227,4.132231405,8.510638298,4.444444444,4.62962963,0.0,4.739336493,20.30456853,10.15228426,0.0,11.11111111,0.0,17.06484642,31.25,29.41176471,26.51515152,46.33204633,51.38339921,20.24291498,44.0,67.79661017,65.50218341,41.32231405,34.04255319,31.11111111,23.14814815,69.30693069,37.91469194,65.32663317,35.53299492,78.94736842,50.0,113.7724551,-17.06484642,-24.30555556,-29.41176471,-26.51515152,-46.33204633,-39.5256917,-20.24291498,-44.0,-59.3220339,-61.13537118,-37.19008264,-25.53191489,-26.66666667,-18.51851852,-69.30693069,-33.17535545,-45.22613065,-25.38071066,-78.94736842,-38.88888889,-101.7964072,17,17,0,16,16,0,1,1,0,11,10,1,14,12,2,-3,-2,-1,22,22,0,17,17,0,5,5,0,2,2,0,11,11,0,-9,-9,0,4,3,1,8,8,0,-4,-5,1,13,13,0,9,9,0,4,4,0,19,18,1,10,10,0,9,8,1,14,11,3,8,8,0,6,3,3,11,11,0,9,9,0,2,2,0,7.0,4.0,5.0,2.0,3.0,12.0,1.0,10.0,8.0,6.0,7.0,15.0,7.0,17.0,10.0,9.0,10.0,11.0,17.0,14.0,15.0,16.0,15.0,21.0,11.0,17.0,22.0,9.0,24.0,23.0,22.0,21.0,20.0,21.0,24.0,22.0,27.0,22.0,12.0,25.0,13.0,28.0,19.0,21.0,30.0,12.0,23.0,36.0,8.0,21.0,26.0,17.0,15.0,16.0,6.0,8.0,10.0,2.0,3.0,2.0,0.0,1.0,0.0,5.0,2.0,4.0,1.0,2.0,4.0,0.0,5.0,6.0,4.0,4.0,10.0,4.0,13.0,7.0,5.0,5.0,7.0,12.0,9.0,9.0,8.0,9.0,12.0,10.0,12.0,10.0,6.0,14.0,13.0,13.0,11.0,13.0,15.0,14.0,16.0,13.0,14.0,9.0,15.0,10.0,17.0,12.0,16.0,10.0,7.0,7.0,21.0,6.0,10.0,8.0,4.0,8.0,4.0,2.0,3.0,1.0,0.0,1.0,2.0,0.0,1.0,0.0,2.0,2.0,1.0,1.0,1.0,8.0,1.0,5.0,2.0,2.0,3.0,5.0,3.0,4.0,3.0,4.0,5.0,4.0,5.0,5.0,6.0,8.0,6.0,9.0,1.0,5.0,12.0,3.0,10.0,10.0,9.0,10.0,7.0,6.0,10.0,6.0,14.0,8.0,3.0,10.0,3.0,11.0,7.0,5.0,20.0,5.0,16.0,15.0,2.0,11.0,18.0,13.0,7.0,12.0,4.0,5.0,9.0,2.0,2.0,0.0,0.0,0.0,0.0,7.26744186,5.802047782000001,4.0983606560000005,85,11,49,8,43,4,63,14,49,9,43,6,17,10,148,105,89,43.02325581,35.83617747,36.47540984,113.6645963,138.2113821,139.21568630000002,171,171,145,49.70930233,58.36177474,59.42622951,111.54970759999999,78.40350877,71.37931034,86.54970759999999,61.40350877,61.37931034,592.0,617.6470588,890.0,885,257.2674419,23.89078498,70,21.72131148,53,80.0,314.2857143,450.0,34.16149068,55,9.090909091,65.04065041,80,5.0,42.15686275,43,16.27906977,1.8181818180000002,2.5,4.651162791,27481.6504,31127912.54,244.0,255.0,255.0,257.0,254.0,265.0,279.0,285.0,293.0,299.0,298.0,293.0,301.0,317.0,317.0,325.0,342.0,355.0,344.0,327.0,319.0,321.0,334.0,347.0,357.5,368.0,396.0,515.0,652.0,856.0,918.0,957.0,973.0,1035.0,1037.0,1083.0,31.12791252,34.79192507,33.31415171,33.24990069,31.2581192,30.74411107,29.49121626,27.49943477,20.94583116,16.54463657,12.72170113,11.82218691,11.48486908,11.14755125,10.72991964,10.31228804,10.24803702,10.50504109,11.05117472,11.40455531,10.98692371,10.44079007,10.18378601,10.18378601,9.669777882,9.412773818,9.573401358,9.605526866,9.412773818,9.155769755,8.963016708,8.513259597000001,8.15987901,8.256255533,8.192004518,8.192004518,7.838623931,0,0,0,0,1,33125.33501,7446.852387999999,8537.765791,7740.221673,2489.149577,1,8,0.006117445,0,0.0,0.0,1.0,0.99
39081,2462,Cantabria,Cantabria,Saro,134,809,675,351.06568,148.08771399999998,0.17336,40.543007,40.369647,13.573247,6.9494940000000005,13129.10022,17851.94571,4722.845491,15461.1575,911.348784,4795.311296,11167.00765,6371.696358,7989.661190000001,1335.546379,4755.028251,11301.68881,6546.660554,8012.0207120000005,1395.018165,7466.076912,13239.21859,5773.1416770000005,10505.682990000001,1174.167553,1.0,3.0,2.0,2.0,3.0,6.0,5,3,7,2,1,3,1,1,3,2,3,5,4,4,1,6.0,2.0,3.0,11.0,6.0,4.0,5,9,3,2,4,3,4,6,4,6,4,8,11,7,13,-5,1,-1,-9,-3,2,0,-6,4,0,-3,0,-3,-5,-1,-4,-1,-3,-7,-3,-12,0.382555471,1.158301158,0.771307366,0.774293457,1.158301158,2.307692308,1.953125,1.18623962,2.797761791,0.8012820509999999,0.401123145,1.207729469,0.397772474,0.39525691700000004,1.2004801920000001,0.8048289740000001,1.226492232,2.04415372,1.6611295680000002,1.655629139,0.417710944,2.295332823,0.772200772,1.156961049,4.258614015,2.316602317,1.538461538,1.953125,3.5587188610000005,1.199040767,0.8012820509999999,1.604492579,1.207729469,1.5910898969999998,2.371541502,1.600640256,2.414486922,1.622060016,3.2706459530000003,4.568106312,2.8973509930000003,5.430242272,-1.912777353,0.386100386,-0.385653683,-3.484320557,-1.158301158,0.769230769,0.0,-2.3724792409999997,1.5987210230000002,0.0,-1.203369434,0.0,-1.193317422,-1.976284585,-0.400160064,-1.6096579480000002,-0.405515004,-1.226492232,-2.9069767439999996,-1.2417218540000001,-5.012531328,18,12,6,10,9,1,8,3,5,12,12,0,18,15,3,-6,-3,-3,24,24,0,15,14,1,9,10,-1,19,17,2,16,15,1,3,2,1,19,19,0,15,11,4,4,8,-4,16,16,0,22,21,1,-6,-5,-1,23,20,3,21,20,1,2,0,2,19,19,0,4,4,0,15,15,0,30,27,3,16,16,0,14,11,3,19.0,23.0,16.0,13.0,12.0,15.0,21.0,16.0,32.0,19.0,26.0,20.0,22.0,27.0,28.0,22.0,21.0,34.0,31.0,27.0,36.0,29.0,38.0,44.0,31.0,39.0,47.0,32.0,49.0,30.0,45.0,33.0,30.0,50.0,28.0,35.0,37.0,32.0,40.0,30.0,35.0,40.0,27.0,34.0,37.0,28.0,30.0,15.0,32.0,21.0,12.0,21.0,10.0,9.0,9.0,6.0,5.0,1.0,0.0,0.0,0.0,0.0,0.0,7.0,10.0,10.0,8.0,8.0,9.0,8.0,11.0,16.0,13.0,11.0,9.0,17.0,14.0,16.0,11.0,10.0,15.0,14.0,13.0,18.0,16.0,19.0,19.0,16.0,19.0,29.0,20.0,26.0,18.0,24.0,18.0,19.0,27.0,19.0,19.0,21.0,17.0,14.0,17.0,14.0,26.0,14.0,19.0,21.0,12.0,15.0,3.0,14.0,10.0,4.0,7.0,6.0,2.0,6.0,1.0,2.0,0.0,0.0,0.0,0.0,0.0,0.0,12.0,13.0,6.0,5.0,4.0,6.0,13.0,5.0,16.0,6.0,15.0,11.0,5.0,13.0,12.0,11.0,11.0,19.0,17.0,14.0,18.0,13.0,19.0,25.0,15.0,20.0,18.0,12.0,23.0,12.0,21.0,15.0,11.0,23.0,9.0,16.0,16.0,15.0,26.0,13.0,21.0,14.0,13.0,15.0,16.0,16.0,15.0,12.0,18.0,11.0,8.0,14.0,4.0,7.0,3.0,5.0,3.0,1.0,0.0,0.0,0.0,0.0,0.0,12.0,10.0591716,10.21194605,60,28,71,22,78,30,58,35,71,29,78,23,51,53,118,136,148,22.47619048,26.82445759,28.51637765,105.078125,105.26315790000001,110.12145749999999,344,320,318,65.52380952,63.11637081,61.27167629999999,97.30232558,93.5,99.5408805,34.30232558,42.5,46.5408805,187.30158730000002,266.6666667,279.24528300000003,88,16.76190476,30.17751479,153,23.69942197,123,200.0,123.07692309999999,194.7368421,41.40625,106,15.09433962,72.06477733,178,12.92134831,35.22267206,87,21.83908046,5.660377358,7.303370787,13.79310345,23094.81089,17975254.02,519.0,516.0,504.0,512.0,515.0,512.0,511.0,504.0,515.0,510.0,504.0,507.0,520.0,518.0,513.0,510.0,512.0,522.0,525.0,532.0,525.0,527.0,530.0,534.0,540.5,547.0,560.0,614.0,595.0,485.0,692.0,765.0,656.0,713.0,649.0,709.0,17.97525406,39.44311428,36.10519205,39.66564243,36.49461631,42.55850835,38.49736965,26.98153798,33.10106205,34.15807076,31.15394075,30.43072427,30.06911603,29.70750779,29.48497964,29.31808353,29.20681946,29.59624372,29.20681946,29.03992335,28.48360298,28.372338899999995,28.53923501,28.8173952,28.92865927,28.20544279,28.03854668,28.372338899999995,28.65049909,28.03854668,28.42797094,28.48360298,28.65049909,28.48360298,28.03854668,28.70613112,28.87302724,0,0,0,0,1,21422.32376,5433.416418,3670.606638,5507.394358,2111.942556,7,27,0.025728675,0,0.44,0.02,1.0,0.97
39082,2463,Cantabria,Cantabria,Selaya,208,1212,1004,537.546025,185.139985,0.367749,45.433411,45.065661999999996,17.263489,7.985985,18840.01174,25709.454869999998,6869.443134,22534.08929,1692.5845399999998,7535.140348999999,14901.39746,7366.257109,11324.2621,1867.743982,11648.29825,19140.27497,7491.976729000001,15363.513140000001,1801.836754,12476.85992,18245.00677,5768.146846,15711.39746,1254.435514,10.0,13.0,19.0,13.0,14.0,10.0,10,12,18,9,14,18,20,17,15,14,10,18,10,8,13,17.0,25.0,25.0,25.0,26.0,22.0,23,16,13,13,16,23,31,22,25,24,32,27,23,22,26,-7,-12,-6,-12,-12,-12,-13,-4,5,-4,-2,-5,-11,-5,-10,-10,-22,-9,-13,-14,-13,26.24671916,34.66666667,50.26455026,33.50515464,35.53299492,26.24671916,26.59574468,33.33333333,49.86149584,24.59016393,38.56749311,49.58677686,56.98005698,51.05105105,45.87155963,42.94478528,34.36426117,61.8556701,35.84229391,29.96254682,36.49635036,44.61942257,66.66666667,66.13756614,64.43298969,65.98984772,57.74278215,61.17021277,44.44444444,36.01108033,35.51912568,44.07713499,63.36088154,88.31908832,66.06606607,76.45259939,73.6196319,101.91082800000001,92.78350515,82.43727599,82.39700375,94.89051095,-18.37270341,-32,-15.87301587,-30.92783505,-30.45685279,-31.49606299,-34.57446809,-11.11111111,13.85041551,-10.92896175,-5.509641873,-13.77410468,-31.33903134,-15.01501502,-30.58103976,-30.67484663,-70.06369427,-30.92783505,-46.59498208,-52.43445693,-47.44525547,47,43,4,49,42,7,-2,1,-3,59,55,4,55,55,0,4,0,4,34,31,3,69,68,1,-35,-37,2,58,57,1,36,36,0,22,21,1,66,60,6,52,52,0,14,8,6,50,48,2,69,67,2,-19,-19,0,78,70,8,64,63,1,14,7,7,53,48,5,57,56,1,-4,-8,4,54,51,3,56,52,4,-2,-1,-1,58.0,56.0,68.0,76.0,71.0,86.0,63.0,88.0,93.0,65.0,106.0,118.0,80.0,117.0,162.0,102.0,146.0,135.0,99.0,154.0,151.0,126.0,146.0,141.0,137.0,154.0,151.0,128.0,151.0,129.0,144.0,143.0,125.0,157.0,132.0,128.0,147.0,135.0,95.0,122.0,107.0,103.0,123.0,91.0,112.0,88.0,106.0,80.0,61.0,67.0,55.0,56.0,40.0,30.0,18.0,15.0,8.0,3.0,1.0,4.0,1.0,0.0,0.0,37.0,28.0,38.0,43.0,35.0,45.0,31.0,38.0,40.0,29.0,45.0,61.0,40.0,57.0,90.0,48.0,85.0,78.0,49.0,79.0,72.0,72.0,75.0,73.0,72.0,81.0,77.0,52.0,82.0,71.0,83.0,67.0,66.0,80.0,73.0,68.0,72.0,75.0,62.0,67.0,55.0,49.0,63.0,50.0,54.0,43.0,42.0,31.0,30.0,31.0,14.0,17.0,12.0,12.0,6.0,2.0,3.0,1.0,0.0,2.0,1.0,0.0,0.0,21.0,28.0,30.0,33.0,36.0,41.0,32.0,50.0,53.0,36.0,61.0,57.0,40.0,60.0,72.0,54.0,61.0,57.0,50.0,75.0,79.0,54.0,71.0,68.0,65.0,73.0,74.0,76.0,69.0,58.0,61.0,76.0,59.0,77.0,59.0,60.0,75.0,60.0,33.0,55.0,52.0,54.0,60.0,41.0,58.0,45.0,64.0,49.0,31.0,36.0,41.0,39.0,28.0,18.0,12.0,13.0,5.0,2.0,1.0,2.0,0.0,0.0,0.0,12.51266464,10.61204344,10.62567422,227,124,235,114,244,86,165,123,235,101,244,111,215,197,392,427,472,19.85815603,21.07601185,25.45846818,103.92561979999999,99.80276134,101.9607843,1335,1384,1185,67.62917933,68.31194472,63.91585761,276.36329589999997,245.8526012,236.83122360000002,29.36329588,30.85260116,39.83122363,158.7044534,198.60465119999998,239.59390860000002,256,12.96859169,29.86179664,605,26.42934196,490,80.50847458,127.3584906,226.15384619999998,46.59090909,451,15.07760532,81.16370809,823,6.8043742410000005,33.76906318,310,18.70967742,6.651884701,3.40218712,6.7741935479999995,25959.56535,39147479.06,1854.0,1873.0,1891.0,1891.0,1915.0,1931.0,1922.0,1990.0,1997.0,2009.0,2035.0,2026.0,2044.0,2003.0,1985.0,1981.0,1982.0,1983.0,1974.0,1998.0,1995.0,2010.0,2004.0,1963.0,1975.0,1987.0,2169.0,1821.0,2019.0,1983.0,2043.0,2091.0,2046.0,2150.0,1855.0,1937.0,39.14748001,49.479557799999995,47.38491467,54.92052105,52.2639005,53.41339977,52.18726721,50.65460151,51.57420093,46.51640411,55.40586519,50.75677922,50.45024608,50.14371294,51.1910345,51.34430107,50.96113465,51.03776793,50.42470165,50.65460151,50.62905708,50.60351265,50.70569036,51.16549008,52.21281164,51.75301193,51.98291178,51.31875665,51.01222351,50.83341251,49.09639138,49.32629123,48.91758038,48.3045141,48.3045141,47.84471438,47.35937025,0,0,0,1,1,28695.42591,5006.550018999999,4930.850265,4161.276951,3441.3753509999997,12,85,0.0021096039999999997,0,0.0,0.0,0.96,0.99
39083,2464,Cantabria,Cantabria,Soba,88,1603,1515,776.455896,315.147983,0.122584,62.159378000000004,62.03679399999999,18.674363,9.606822,18308.60791,32658.053089999998,14349.44518,25739.3891,3098.8915269999998,19.447819,18195.292569999998,18175.84475,7817.9714349999995,5231.704696,14185.674969999998,27866.062169999997,13680.3872,20886.908369999997,2836.741799,4289.125000999999,16861.49108,12572.36608,11041.88375,3080.5234739999996,7.0,2.0,7.0,9.0,5.0,2.0,7,6,3,3,1,6,6,10,5,2,6,4,9,2,2,22.0,25.0,26.0,19.0,21.0,25.0,21,19,22,18,16,17,16,32,19,15,11,15,25,15,14,-15,-23,-19,-10,-16,-23,-14,-13,-19,-15,-15,-11,-10,-22,-14,-13,-5,-11,-16,-13,-12,6.113537118,1.731601732,6.092254134,7.950530035,4.464285714,1.793721973,6.493506494,5.499541705,2.7497708519999997,2.7051397660000003,0.8771929820000001,5.338078292,5.439709882000001,9.233610342,4.708097928,1.937984496,5.917159763,3.9447731760000004,8.746355685,1.994017946,7.042253521,19.2139738,21.64502165,22.6283725,16.7844523,18.75,22.42152466,19.48051948,17.415215399999997,20.16498625,16.23083859,14.03508772,15.12455516,14.50589302,29.54755309,17.89077213,14.53488372,10.81612586,14.79289941,24.29543246,14.9551346,14.08450704,-13.10043668,-19.91341991,-16.53611836,-8.833922261,-14.28571429,-20.62780269,-12.98701299,-11.91567369,-17.415215399999997,-13.52569883,-13.15789474,-9.786476868,-9.066183137000001,-20.31394275,-13.1826742,-12.59689922,-4.916420846,-10.84812623,-15.54907677,-12.96111665,-12.07243461,34,33,1,38,37,1,-4,-4,0,33,33,0,39,37,2,-6,-4,-2,46,45,1,46,46,0,0,-1,1,47,46,1,46,46,0,1,0,1,20,19,1,57,57,0,-37,-38,1,36,30,6,37,37,0,-1,-7,6,40,36,4,45,43,2,-5,-7,2,17,17,0,32,32,0,-15,-15,0,42,42,0,33,33,0,9,9,0,29.0,20.0,32.0,33.0,27.0,57.0,21.0,49.0,60.0,20.0,61.0,93.0,46.0,78.0,99.0,46.0,78.0,80.0,56.0,64.0,102.0,76.0,89.0,106.0,59.0,110.0,122.0,81.0,134.0,86.0,100.0,94.0,112.0,122.0,103.0,93.0,106.0,101.0,81.0,95.0,73.0,99.0,90.0,80.0,103.0,58.0,80.0,83.0,51.0,64.0,71.0,32.0,44.0,42.0,27.0,15.0,7.0,3.0,3.0,1.0,2.0,0.0,0.0,14.0,8.0,17.0,19.0,16.0,30.0,9.0,27.0,25.0,11.0,30.0,48.0,25.0,37.0,49.0,26.0,42.0,41.0,31.0,38.0,60.0,43.0,47.0,57.0,37.0,64.0,66.0,41.0,75.0,55.0,65.0,53.0,68.0,58.0,64.0,60.0,61.0,61.0,40.0,60.0,42.0,51.0,54.0,33.0,47.0,37.0,44.0,44.0,20.0,29.0,23.0,15.0,17.0,16.0,14.0,5.0,4.0,0.0,1.0,0.0,1.0,0.0,0.0,15.0,12.0,15.0,14.0,11.0,27.0,12.0,22.0,35.0,9.0,31.0,45.0,21.0,41.0,50.0,20.0,36.0,39.0,25.0,26.0,42.0,33.0,42.0,49.0,22.0,46.0,56.0,40.0,59.0,31.0,35.0,41.0,44.0,64.0,39.0,33.0,45.0,40.0,41.0,35.0,31.0,48.0,36.0,47.0,56.0,21.0,36.0,39.0,31.0,35.0,48.0,17.0,27.0,26.0,13.0,10.0,3.0,3.0,2.0,1.0,1.0,0.0,0.0,9.744931328,7.022677396000001,7.198612316,221,77,188,45,157,41,185,72,188,51,157,42,96,83,406,359,358,26.55330281,26.26188734,31.04943625,110.02747250000002,115.61514199999999,125.1953125,974,912,712,63.70176586,66.71543526,61.75195143,190.68377819999998,135.3640351,133.2808989,41.68377823,39.36403509,50.28089888,272.4832215,373.9583333,431.3253012,529,34.59777632,29.04169715,397,23.59063313,272,87.09677419,165.5737705,530.0,44.09340659,321,9.968847352000001,75.70977918,480,4.166666667,33.7890625,173,16.76300578,4.672897196,2.5,8.670520231,68922.37131,214043184.6,1153.0,1155.0,1180.0,1193.0,1207.0,1249.0,1260.0,1280.0,1305.0,1319.0,1335.0,1367.0,1385.0,1427.0,1442.0,1462.0,1494.0,1530.0,1529.0,1614.0,1637.0,1677.0,1699.0,1711.0,1724.0,1737.0,1856.0,2023.0,2691.0,3345.0,4097.0,4166.0,4323.0,4315.0,4367.0,3756.0,214.0431824,17.54786094,20.40242512,20.15948348,20.19685912,19.46336227,19.14099741,15.62768766,12.57222945,9.451363868,8.671147473,8.115184893,8.054449485,7.993714077000001,7.937650623,7.834867625,7.6479894470000005,7.540534495,7.143418366000001,7.14809032,6.97989996,6.830397417,6.736958327999999,6.666879011,6.470656924,6.386561743,6.237059201,6.16230793,6.0969005670000005,5.980101706,5.886662617000001,5.835271118,5.63904903,5.573641668,5.51290626,5.396107398,5.38676349,0,1,0,0,2,26250.320880000003,3070.142259,8915.030394,9375.279806999999,3714.54809,30,167,2.0926942680000002,0,1.0,0.0,1.0,1.0
39086,2465,Cantabria,Cantabria,Tojos (Los),344,1314,970,791.4067200000001,191.891734,0.27410500000000004,43.142975,42.868869000000004,18.623991,7.525985,11049.5346,22913.41874,11863.88414,17032.53531,2979.8030940000003,5840.8782759999995,19650.90664,13810.02836,12990.04324,3165.504004,3383.136672,18562.83398,15179.69731,11214.49765,3480.579101,5981.465947,19631.25174,13649.78579,12976.49953,3188.309366,2.0,1.0,0.0,2.0,2.0,1.0,1,1,1,6,0,1,3,6,2,1,1,0,3,4,4,1.0,4.0,1.0,5.0,3.0,6.0,4,3,2,7,1,4,3,5,4,4,3,5,7,7,6,1,-3,-1,-3,-1,-5,-3,-2,-1,-1,-1,-3,0,1,-2,-3,-2,-5,-4,-3,-2,0.572901747,0.284333239,0,0.552486188,0.544810678,0.271591526,0.26062027600000004,0.253100481,0.246791708,1.435750179,0.0,0.23640661899999998,0.700770848,1.410105758,0.473036897,0.23900573600000002,0.236854571,0.0,0.711068974,0.932835821,0.463070155,0.286450874,1.137332954,0.277623542,1.38121547,0.817216017,1.629549158,1.042481105,0.759301443,0.493583416,1.6750418759999999,0.23906287399999998,0.945626478,0.700770848,1.175088132,0.946073794,0.956022945,0.7175316909999999,1.184272856,1.6591609390000002,1.6324626869999999,1.389210465,0.286450874,-0.852999716,-0.277623542,-0.828729282,-0.272405339,-1.357957632,-0.7818608290000001,-0.506200962,-0.246791708,-0.239291697,-0.23906287399999998,-0.709219858,0.0,0.235017626,-0.473036897,-0.717017208,-0.478354461,-1.184272856,-0.948091965,-0.6996268659999999,-0.463070155,17,16,1,12,12,0,5,4,1,15,15,0,23,23,0,-8,-8,0,13,13,0,27,27,0,-14,-14,0,13,13,0,16,11,5,-3,2,-5,13,8,5,7,6,1,6,2,4,10,9,1,6,6,0,4,3,1,15,14,1,21,21,0,-6,-7,1,21,17,4,18,17,1,3,0,3,27,25,2,16,15,1,11,10,1,9.0,9.0,6.0,7.0,8.0,7.0,7.0,9.0,10.0,11.0,12.0,12.0,13.0,19.0,27.0,12.0,35.0,28.0,18.0,37.0,29.0,16.0,22.0,32.0,36.0,45.0,26.0,34.0,23.0,43.0,40.0,39.0,40.0,32.0,46.0,31.0,34.0,32.0,26.0,36.0,39.0,26.0,29.0,17.0,34.0,28.0,32.0,18.0,13.0,12.0,14.0,17.0,12.0,13.0,4.0,1.0,2.0,1.0,0.0,0.0,0.0,0.0,0.0,8.0,4.0,6.0,4.0,3.0,2.0,1.0,6.0,9.0,8.0,7.0,8.0,5.0,13.0,12.0,8.0,19.0,20.0,10.0,19.0,18.0,11.0,16.0,16.0,26.0,31.0,16.0,22.0,11.0,23.0,25.0,22.0,29.0,17.0,30.0,15.0,19.0,18.0,13.0,26.0,22.0,16.0,14.0,9.0,19.0,16.0,17.0,10.0,6.0,8.0,5.0,6.0,2.0,6.0,3.0,0.0,1.0,0.0,0.0,0.0,0.0,0.0,0.0,1.0,5.0,0.0,3.0,5.0,5.0,6.0,3.0,1.0,3.0,5.0,4.0,8.0,6.0,15.0,4.0,16.0,8.0,8.0,18.0,11.0,5.0,6.0,16.0,10.0,14.0,10.0,12.0,12.0,20.0,15.0,17.0,11.0,15.0,16.0,16.0,15.0,14.0,13.0,10.0,17.0,10.0,15.0,8.0,15.0,12.0,15.0,8.0,7.0,4.0,9.0,11.0,10.0,7.0,1.0,1.0,1.0,1.0,0.0,0.0,0.0,0.0,0.0,5.424528302000001,5.79064588,5.793450882,50,6,55,13,57,10,57,17,55,13,57,13,26,23,107,113,128,25.23584906,25.16703786,32.2418136,135.5555556,133.8541667,145.0617284,294,310,246,69.33962264,69.04231626,61.96473552,59.39455782,62.45161289999999,75.03252033,36.39455782,36.45161289999999,52.03252033,465.2173913,434.61538459999997,556.5217391,373,87.97169811,28.28507795,127,26.19647355,104,216.66666669999998,266.6666667,309.0909091,50.0,90,6.666666667,88.54166667,170,5.294117647,41.97530864,68,13.23529412,0.0,2.9411764710000003,1.470588235,45982.112030000004,89455381.08,397.0,387.0,387.0,400.0,402.0,399.0,404.0,422.0,430.0,428.0,434.0,449.0,442.0,434.0,441.0,412.0,409.0,415.0,424.0,419.0,403.0,398.0,397.0,394.0,397.0,400.0,404.0,406.0,498.0,706.0,790.0,866.0,819.0,829.0,764.0,804.0,89.4553833,8.987720698,8.540570414,9.267189625,9.155402054,9.680803637,8.831218097999999,7.892202502999999,5.567021029,4.538575377,4.5162178630000005,4.471502835,4.437966563,4.404430292,4.437966563,4.44914532,4.505039106,4.683899219,4.739793005,4.639184191,4.572111648,4.60564792,4.929831875,4.851580576,4.941010632,5.019261932,4.851580576,4.784508033,4.806865547,4.717435491,4.5162178630000005,4.460324078,4.493860349,4.471502835,4.326178992,4.326178992,4.437966563,0,0,0,0,1,27375.85736,14336.85817,13334.62059,14556.804709999999,5332.784744,2,12,0.041312817,0,0.0,0.0,1.0,0.95
39088,2467,Cantabria,Cantabria,Tresviso,89,1551,1462,1032.654072,282.65911,0.6934100000000001,57.256172,56.562763000000004,25.537126,11.015862,48324.63884,55885.629460000004,7560.9906120000005,52584.42963,1676.535541,1912.566004,9348.716125,7436.150121,6073.757497,1963.178807,15433.10191,20053.70115,4620.599241,17669.29327,897.1841,13938.47361,18665.194030000002,4726.720418999999,15880.52797,1026.591623,0.0,0.0,1.0,0.0,0.0,0.0,0,0,0,0,0,0,1,0,0,0,1,0,0,0,0,0.0,1.0,0.0,0.0,0.0,2.0,1,0,2,0,2,1,2,1,1,1,0,1,2,1,1,0,-1,1,0,0,-2,-1,0,-2,0,-2,-1,-1,-1,-1,-1,1,-1,-2,-1,-1,0,0,1,0,0,0,0.0,0.0,0.0,0.0,0.0,0.0,0.589622642,0.0,0.0,0.0,0.583771162,0.0,0.0,0.0,0.0,0,1.058201058,0,0,0,1.47601476,0.692520776,0.0,1.239157373,0.0,1.202645821,0.58411215,1.179245283,0.584453536,0.586510264,0.573394495,0.0,0.583771162,1.1607661059999999,0.57208238,0.559284116,0,-1.058201058,1,0,0,-1.47601476,-0.692520776,0.0,-1.239157373,0.0,-1.202645821,-0.58411215,-0.589622642,-0.584453536,-0.586510264,-0.573394495,0.581395349,-0.583771162,-1.1607661059999999,-0.57208238,-0.559284116,2,2,0,3,3,0,-1,-1,0,2,2,0,0,0,0,2,2,0,5,4,1,2,2,0,3,2,1,5,5,0,4,4,0,1,1,0,2,2,0,3,3,0,-1,-1,0,0,0,0,5,5,0,-5,-5,0,2,2,0,2,2,0,0,0,0,0,0,0,2,2,0,-2,-2,0,2,2,0,3,3,0,-1,-1,0,0.0,1.0,1.0,1.0,2.0,1.0,0.0,0.0,2.0,1.0,0.0,1.0,0.0,4.0,0.0,2.0,3.0,1.0,3.0,0.0,3.0,3.0,2.0,5.0,2.0,3.0,7.0,1.0,10.0,5.0,4.0,7.0,5.0,9.0,15.0,3.0,6.0,7.0,2.0,14.0,4.0,4.0,6.0,2.0,10.0,3.0,8.0,5.0,1.0,7.0,5.0,2.0,2.0,2.0,0.0,1.0,0.0,1.0,0.0,0.0,0.0,0.0,0.0,0.0,0.0,0.0,1.0,1.0,1.0,0.0,0.0,0.0,0.0,0.0,0.0,0.0,2.0,0.0,2.0,3.0,0.0,2.0,0.0,2.0,3.0,1.0,3.0,1.0,1.0,5.0,1.0,7.0,4.0,3.0,6.0,5.0,6.0,11.0,2.0,6.0,5.0,2.0,8.0,3.0,2.0,5.0,1.0,3.0,2.0,4.0,3.0,0.0,4.0,2.0,0.0,0.0,0.0,0.0,0.0,0.0,0.0,0.0,0.0,0.0,0.0,0.0,0.0,1.0,1.0,0.0,1.0,0.0,0.0,0.0,2.0,1.0,0.0,1.0,0.0,2.0,0.0,0.0,0.0,1.0,1.0,0.0,1.0,0.0,1.0,2.0,1.0,2.0,2.0,0.0,3.0,1.0,1.0,1.0,0.0,3.0,4.0,1.0,0.0,2.0,0.0,6.0,1.0,2.0,1.0,1.0,7.0,1.0,4.0,2.0,1.0,3.0,3.0,2.0,2.0,2.0,0.0,1.0,0.0,1.0,0.0,0.0,0.0,0.0,0.0,6.451612902999999,3.8461538460000004,1.694915254,16,3,12,2,12,0,10,1,12,1,12,1,3,1,26,24,27,41.93548387,30.76923077,45.76271186,121.42857140000001,168.96551719999997,210.52631580000002,32,51,31,51.61290323,65.38461538,52.54237288,85.25,50.05882353,88.09677419,81.25,47.05882353,87.09677419,650.0,800.0,2700.0,12643,20391.93548,19.23076923,15,15.25423729,9,200.0,0.0,600.0,35.71428571,10,10.0,41.37931034,12,8.333333332999999,42.10526316,8,0.0,10.0,8.333333332999999,0.0,22351.37839,16259857.66,59.0,59.0,62.0,64.0,70.0,71.0,71.0,69.0,70.0,74.0,74.0,78.0,80.0,82.0,85.0,76.0,69.0,63.0,62.0,55.0,59.0,60.0,60.0,60.0,61.0,62.0,67.0,91.0,178.0,319.0,395.0,394.0,433.0,485.0,414.0,377.0,16.25985718,23.18593551,25.46147826,29.82806028,26.63000021,24.23145515,24.29295631,19.61886851,10.94720563,5.596605124,4.120577399,3.813071623,3.751570468,3.690069313,3.690069313,3.690069313,3.6285681569999997,3.382563537,3.813071623,3.874572778,4.24357971,4.674087796,5.227598193,5.043094727,4.920092417,4.797090106000001,4.551085486,4.551085486,4.305080865,4.24357971,4.36658202,4.36658202,4.305080865,3.936073934,3.813071623,3.6285681569999997,3.6285681569999997,0,0,0,0,0,42756.5649,4905.974491,11068.64535,11261.736859999999,4033.6442,2,4,1.190885773,0,0.0,0.0,1.0,1.0
39089,2468,Cantabria,Cantabria,Tudanca,269,1877,1608,838.304579,289.754225,0.38764099999999996,48.494053,48.106412,21.138335,7.833895,19112.3138,29039.23087,9926.917073999999,24882.15753,2441.016022,12078.46364,21857.87291,9779.40927,17911.801,2284.699061,12970.91905,23604.896719999997,10633.977659999999,19276.73138,2397.514759,11971.283879999999,23249.896109999998,11278.61224,18601.390730000003,2664.433115,0.0,1.0,0.0,2.0,1.0,0.0,0,1,2,0,0,0,0,0,0,0,0,1,1,0,1,1.0,5.0,4.0,0.0,2.0,3.0,8,3,2,1,4,4,2,3,3,3,5,4,2,3,1,-1,-4,-4,2,-1,-3,-8,-2,0,-1,-4,-4,-2,-3,-3,-3,-5,-3,-1,-3,0,0,0.556792873,0,1.049317943,0.516262261,0,0.0,0.48239266799999997,0.9341429240000001,0.0,0.0,0.0,0.0,0.0,0.0,0.0,0.0,0.476644423,0.474383302,0.0,0.0,0.560852496,2.783964365,2.105263158,0,1.032524522,1.533742331,3.948667325,1.447178003,0.9341429240000001,0.471253534,1.889466226,1.903855307,0.945626478,1.413760603,1.4238253440000002,1.411764706,2.391200383,1.906577693,0.9487666029999999,1.426533524,0.47483380799999997,-0.560852496,-2.227171492,-2.105263158,1.049317943,-0.516262261,-1.533742331,-3.948667325,-0.964785335,0.0,-0.471253534,-1.889466226,-1.903855307,-0.945626478,-1.413760603,-1.4238253440000002,-1.411764706,-2.391200383,-1.42993327,-0.474383302,-1.426533524,0.0,7,7,0,15,15,0,-8,-8,0,9,8,1,7,7,0,2,1,1,16,16,0,7,7,0,9,9,0,13,12,1,17,16,1,-4,-4,0,7,7,0,6,6,0,1,1,0,7,5,2,10,10,0,-3,-5,2,5,5,0,7,7,0,-2,-2,0,1,1,0,5,5,0,-4,-4,0,19,18,1,6,6,0,13,12,1,4.0,2.0,3.0,1.0,2.0,3.0,3.0,1.0,3.0,3.0,5.0,4.0,4.0,7.0,5.0,7.0,8.0,16.0,10.0,6.0,15.0,6.0,12.0,18.0,8.0,14.0,17.0,11.0,19.0,16.0,16.0,17.0,9.0,21.0,11.0,17.0,18.0,16.0,12.0,5.0,11.0,21.0,11.0,16.0,29.0,8.0,18.0,19.0,5.0,12.0,8.0,4.0,7.0,5.0,3.0,1.0,4.0,0.0,0.0,1.0,0.0,0.0,0.0,0.0,1.0,2.0,1.0,1.0,2.0,2.0,1.0,1.0,2.0,4.0,4.0,2.0,6.0,5.0,4.0,7.0,6.0,7.0,3.0,12.0,4.0,9.0,16.0,7.0,12.0,13.0,7.0,13.0,14.0,15.0,15.0,6.0,17.0,7.0,11.0,13.0,11.0,7.0,5.0,5.0,13.0,8.0,12.0,16.0,3.0,11.0,8.0,4.0,3.0,3.0,2.0,5.0,3.0,1.0,0.0,0.0,0.0,0.0,0.0,0.0,0.0,0.0,4.0,1.0,1.0,0.0,1.0,1.0,1.0,0.0,2.0,1.0,1.0,0.0,2.0,1.0,0.0,3.0,1.0,10.0,3.0,3.0,3.0,2.0,3.0,2.0,1.0,2.0,4.0,4.0,6.0,2.0,1.0,2.0,3.0,4.0,4.0,6.0,5.0,5.0,5.0,0.0,6.0,8.0,3.0,4.0,13.0,5.0,7.0,11.0,1.0,9.0,5.0,2.0,2.0,2.0,2.0,1.0,4.0,0.0,0.0,1.0,0.0,0.0,0.0,4.0,2.702702703,5.405405405,44,4,29,2,13,5,43,5,29,3,13,3,5,8,87,65,36,38.66666667,35.13513514,24.32432432,171.08433730000002,213.559322,236.36363640000002,129,115,104,57.33333333,62.16216216,70.27027027,76.44186047,61.52173913,42.61538462,67.44186047,56.52173913,34.61538462,966.6666667000002,1300.0,450.0,31,13.77777778,27.56756757,51,23.64864865,35,300.0,320.0,600.0,67.46987952,56,5.3571428569999995,88.13559322,52,3.8461538460000004,59.09090909,26,15.38461538,1.785714286,1.9230769230000002,15.38461538,35403.7612,52600641.57,148.0,135.0,141.0,140.0,145.0,147.0,154.0,148.0,151.0,163.0,174.0,185.0,196.0,202.0,215.0,201.0,215.0,212.0,225.0,245.0,258.0,269.0,264.0,264.0,269.5,275.0,255.0,430.0,646.0,832.0,1188.0,932.0,1044.0,766.0,792.0,756.0,52.60064316,14.37244784,15.05685012,14.56255958,19.84766606,17.71841453,22.58527517,15.81729709,12.28121865,8.174804987,4.847849469,5.228072957,5.123511498,5.018950038,5.018950038,5.11400591,4.904882992,4.657737725,4.277514237,4.03036897,4.087402493,3.821246052,4.087402493,3.8402572260000003,3.72619018,3.517067262,3.3079443439999996,3.098821425,2.8706873330000002,2.813653809,2.927720856,2.794642635,2.7566202860000004,2.661564414,2.680575589,2.566508542,2.813653809,0,1,0,0,1,32837.53989,7172.404422,16570.97808,8619.321231,3087.800815,2,11,0.039698343999999997,0,0.0,0.0,1.0,1.0
39092,2469,Cantabria,Cantabria,Valdeolea,906,1527,621,1017.329197,94.400724,0.0,28.227594,28.227594,7.237073,4.972708,6139.179307,18332.89391,12193.7146,11588.78642,2811.6450449999998,36.190103,8486.546012,8450.355909,3798.637543,1907.005969,126.01506599999999,8836.265386,8710.250320000001,4266.610320000001,1898.230244,37.270926,9633.694498,9596.423573,3971.0170450000005,2213.5566280000003,6.0,9.0,5.0,1.0,3.0,8.0,5,7,4,0,9,7,3,5,5,2,2,4,3,3,4,24.0,22.0,13.0,16.0,13.0,18.0,18,26,17,14,16,22,25,19,24,20,10,28,13,22,34,-18,-13,-8,-15,-10,-10,-13,-19,-13,-14,-7,-15,-22,-14,-19,-18,-8,-24,-10,-19,-30,0.835421888,1.209189843,0.654535934,0.128518185,0.378740058,1.003638188,0.62250996,0.8656937920000001,0.485790624,0.0,1.0814708,0.84306877,0.364342968,0.598802395,0.597442944,0.239434934,0.24021138600000003,0.48042277200000005,0.35932447,0.361402241,0.71787509,3.341687552,2.955797394,1.701793428,2.056290965,1.641206918,2.258185924,2.241035857,3.215434084,2.0646101530000003,1.6722408030000002,1.922614756,2.6496447069999998,3.036191402,2.275449102,2.867726132,2.394349336,1.1983223490000001,3.3629594039999997,1.5570727030000002,2.650283098,4.0679588419999995,-2.506265664,-1.746607551,-1.047257494,-1.92777278,-1.26246686,-1.254547736,-1.618525896,-2.349740292,-1.578819529,-1.6722408030000002,-0.8411439559999999,-1.806575936,-2.671848433,-1.676646707,-2.270283188,-2.1549144019999997,-0.9586578790000001,-2.882536632,-1.197748233,-2.288880858,-3.589375449,21,21,0,38,38,0,-17,-17,0,38,38,0,63,59,4,-25,-21,-4,32,31,1,47,45,2,-15,-14,-1,46,42,4,58,58,0,-12,-16,4,51,49,2,36,36,0,15,13,2,58,57,1,62,61,1,-4,-4,0,46,45,1,50,50,0,-4,-5,1,57,54,3,42,42,0,15,12,3,55,55,0,27,25,2,28,30,-2,16.0,19.0,31.0,14.0,25.0,34.0,17.0,28.0,54.0,25.0,42.0,64.0,21.0,64.0,65.0,42.0,57.0,67.0,38.0,57.0,55.0,44.0,53.0,105.0,52.0,63.0,97.0,45.0,95.0,107.0,60.0,107.0,87.0,87.0,99.0,52.0,94.0,59.0,56.0,93.0,47.0,90.0,69.0,67.0,130.0,43.0,107.0,140.0,46.0,102.0,78.0,69.0,59.0,37.0,31.0,21.0,20.0,13.0,4.0,3.0,3.0,1.0,0.0,9.0,8.0,17.0,6.0,14.0,13.0,8.0,14.0,29.0,13.0,27.0,31.0,11.0,32.0,31.0,24.0,24.0,36.0,24.0,35.0,34.0,22.0,32.0,53.0,33.0,35.0,55.0,23.0,58.0,65.0,37.0,58.0,60.0,58.0,62.0,31.0,55.0,42.0,21.0,50.0,21.0,36.0,44.0,29.0,60.0,22.0,45.0,66.0,14.0,44.0,34.0,25.0,24.0,10.0,9.0,4.0,10.0,3.0,0.0,0.0,0.0,0.0,0.0,7.0,11.0,14.0,8.0,11.0,21.0,9.0,14.0,25.0,12.0,15.0,33.0,10.0,32.0,34.0,18.0,33.0,31.0,14.0,22.0,21.0,22.0,21.0,52.0,19.0,28.0,42.0,22.0,37.0,42.0,23.0,49.0,27.0,29.0,37.0,21.0,39.0,17.0,35.0,43.0,26.0,54.0,25.0,38.0,70.0,21.0,62.0,74.0,32.0,58.0,44.0,44.0,35.0,27.0,22.0,17.0,10.0,10.0,4.0,3.0,3.0,1.0,0.0,8.673469388,6.12244898,5.097613883,282,60,241,36,200,24,216,59,241,36,200,23,72,47,498,408,367,36.29737609,34.69387755,39.80477223,101.7647059,107.04225349999999,113.42592590000001,755,696,508,55.02915452,59.18367347,55.09761388,184.9602649,130.6206897,119.2440945,65.9602649,58.62068966,72.24409449,418.487395,566.6666667000001,780.8510637999999,157,11.44314869,22.78911565,268,19.414316699999997,179,87.5,140.4761905,376.0,35.29411765,240,12.91666667,59.15492958,336,5.654761905,29.39814815,127,12.5984252,5.833333333,3.273809524,5.511811024,39730.214660000005,83631881.12,922.0,939.0,947.0,967.0,994.0,987.0,1020.0,1055.0,1098.0,1133.0,1145.0,1176.0,1216.0,1240.0,1265.0,1301.0,1293.0,1347.0,1372.0,1433.0,1470.0,1503.0,1517.0,1560.0,1593.0,1626.0,1631.0,2310.0,3515.0,4592.0,4033.0,3106.0,3087.0,2805.0,2600.0,2335.0,83.63188171,27.91997444,31.08862251,33.53984082,36.91176064,37.13894673,48.22323637,54.90729021,42.02942619,27.62104538,19.50213204,19.44234623,19.04775987,18.653173499999998,18.13901552,17.97161524,17.57702888,17.13461387,16.40522695,16.10629789,15.46061112,15.55626842,15.12581057,14.8268815,14.5399096,14.0616231,13.69095106,13.54746511,13.12896443,12.61480644,12.19630575,11.80171939,11.88541953,11.56257614,11.32343289,11.22777559,11.02450383,0,0,2,1,1,51475.78525,7545.643729,4621.287201,4632.897484,3965.3126899999997,4,24,0.0015034279999999998,0,1.0,0.0,1.0,1.0
39096,2470,Cantabria,Cantabria,Vega de Li√©bana,325,2492,2167,1174.707547,437.19350599999996,0.122584,56.140625,56.018041000000004,22.156923000000003,8.601386999999999,37326.805889999996,51766.950039999996,14440.14415,43934.544010000005,3238.252728,7.278361,8682.393678,8675.115316,3182.227519,2063.910802,27638.29976,43179.14135,15540.841580000002,35716.37327,3499.05881,22281.76759,32104.474060000004,9822.706466,27744.892439999996,2550.023612,7.0,11.0,7.0,8.0,5.0,7.0,5,3,2,4,1,3,2,3,0,5,2,1,3,1,4,21.0,18.0,12.0,12.0,16.0,13.0,19,12,17,9,15,12,18,12,10,13,14,13,16,12,20,-14,-7,-5,-4,-11,-6,-14,-9,-15,-5,-14,-9,-16,-9,-10,-8,-12,-12,-13,-11,-16,8.905852417,14.23027167,9.433962264,10.94391245,6.944444444,9.79020979,7.142857143,4.379562044,2.9895366219999997,6.134969325,1.540832049,4.6801872069999995,3.129890454,4.601226994,0.0,7.6103500760000005,3.210272873,1.6051364369999999,4.926108374,1.652892562,11.92504259,26.71755725,23.28589909,16.17250674,16.41586867,22.22222222,18.18181818,27.14285714,17.51824818,25.41106129,13.80368098,23.11248074,18.72074883,28.16901408,18.40490798,15.43209877,19.786910199999998,21.84087363,20.86677368,26.272578000000003,19.83471074,34.07155026,-17.81170483,-9.055627426,-6.738544474,-5.471956224,-15.27777778,-8.391608392,-20.0,-13.13868613,-22.42152466,-7.668711656,-21.57164869,-14.04056162,-25.03912363,-13.80368098,-15.43209877,-12.17656012,-18.72074883,-19.26163724,-21.34646962,-18.18181818,-27.257240200000002,24,23,1,32,32,0,-8,-9,1,23,19,4,27,27,0,-4,-8,4,30,28,2,28,27,1,2,1,1,35,34,1,26,26,0,9,8,1,20,19,1,35,34,1,-15,-15,0,26,23,3,35,33,2,-9,-10,1,29,28,1,31,29,2,-2,-1,-1,23,19,4,27,27,0,-4,-8,4,35,32,3,24,24,0,11,8,3,9.0,20.0,31.0,12.0,28.0,26.0,13.0,21.0,29.0,28.0,28.0,33.0,20.0,37.0,45.0,30.0,27.0,54.0,34.0,42.0,60.0,25.0,55.0,74.0,47.0,67.0,80.0,49.0,77.0,53.0,61.0,68.0,38.0,85.0,33.0,44.0,62.0,41.0,50.0,43.0,45.0,66.0,40.0,66.0,91.0,41.0,64.0,69.0,40.0,69.0,60.0,46.0,38.0,24.0,26.0,15.0,16.0,5.0,5.0,3.0,2.0,0.0,0.0,2.0,8.0,15.0,3.0,13.0,14.0,5.0,10.0,11.0,13.0,17.0,17.0,11.0,19.0,29.0,15.0,14.0,27.0,14.0,23.0,32.0,15.0,32.0,35.0,25.0,31.0,55.0,29.0,50.0,36.0,34.0,50.0,23.0,52.0,20.0,24.0,45.0,24.0,24.0,26.0,23.0,29.0,24.0,31.0,51.0,20.0,33.0,27.0,15.0,32.0,34.0,18.0,16.0,8.0,8.0,4.0,5.0,1.0,2.0,1.0,0.0,0.0,0.0,7.0,12.0,16.0,9.0,15.0,12.0,8.0,11.0,18.0,15.0,11.0,16.0,9.0,18.0,16.0,15.0,13.0,27.0,20.0,19.0,28.0,10.0,23.0,39.0,22.0,36.0,25.0,20.0,27.0,17.0,27.0,18.0,15.0,33.0,13.0,20.0,17.0,17.0,26.0,17.0,22.0,37.0,16.0,35.0,40.0,21.0,31.0,42.0,25.0,37.0,26.0,28.0,22.0,16.0,18.0,11.0,11.0,4.0,3.0,2.0,2.0,0.0,0.0,9.090909091,8.156028369,4.735376045,174,46,161,38,131,24,155,40,161,31,131,10,69,34,329,302,243,34.77801268,35.69739953,33.84401114,110.69042320000001,114.7208122,109.32944609999998,531,475,441,56.13107822,56.1465721,61.42061281,147.9585687,132.5789474,89.10204082,61.95856874,63.57894737,55.10204082,382.5581395,437.68115939999996,714.7058824,310,32.76955603,28.48699764,241,21.58774373,155,151.5151515,146.4285714,221.4285714,43.4298441,195,15.8974359,64.97461929,256,7.8125,27.11370262,93,9.677419355,8.205128205,4.6875,7.52688172,51020.0938,133133832.1,718.0,719.0,736.0,745.0,765.0,788.0,793.0,805.0,821.0,842.0,851.0,846.0,871.0,892.0,910.0,936.0,944.0,949.0,946.0,985.0,998.0,999.0,1016.0,1035.0,1049.0,1063.0,1041.0,1148.0,1602.0,2017.0,2368.0,2427.0,2476.0,2431.0,2336.0,2388.0,133.1338348,17.93683779,17.54625338,18.25982105,18.59782679,18.229776100000002,17.78661302,15.15016827,12.03300425,8.62290192,7.819199389,7.984446638,7.879289298,7.774131957000001,7.631418424,7.503727367000001,7.496216129,7.398570027000001,7.105631721,7.128165437000001,7.0906092439999995,7.030519335,6.835227131,6.700024837000001,6.542288826,6.354507861,6.3920640539999996,6.324462906,6.166726895,6.046547078,5.956412215,5.918856021,5.746097534,5.595872761,5.5282716139999994,5.400580558,5.393069318999999,0,1,0,0,1,49751.94043,6115.92915,10087.85035,10052.42456,4584.867152000001,34,128,0.000581178,0,0.0,0.0,1.0,1.0
39093,2471,Cantabria,Cantabria,Valdeprado del R√≠o,750,1275,525,982.275248,101.976454,0.0,34.415546,34.415546,10.039598,5.362587,7940.497383,18318.90355,10378.40617,13750.44533,2250.080835,51.958133000000004,12214.24807,12162.28994,5564.194968,2739.39437,47.387743,12492.3332,12444.945459999999,5643.054025,2735.000727,237.258304,12259.568879999999,12022.31058,6033.720958,2582.962522,1.0,2.0,2.0,4.0,1.0,1.0,1,0,0,2,0,0,2,1,0,3,2,1,4,1,1,6.0,4.0,3.0,3.0,3.0,8.0,3,2,9,5,5,7,4,5,4,3,7,3,8,6,3,-5,-2,-1,1,-2,-7,-2,-2,-9,-3,-5,-7,-2,-4,-4,0,-5,-2,-4,-5,-2,0.428449015,0.829531315,0.803212851,1.571091909,0.358037952,0.340715503,0.318572794,0.0,0.0,0.528541226,0.0,0.0,0.485672657,0.24521824399999997,0.0,0.726920281,0.48402710600000004,0.24201355300000002,0.955566173,0.23551578,0.231535078,2.570694087,1.65906263,1.204819277,1.178318932,1.074113856,2.72572402,0.955718382,0.58702671,2.491004705,1.321353066,1.253761284,1.7182130580000001,0.9713453129999999,1.226091221,0.980392157,0.726920281,1.697381183,0.726040658,1.911132346,1.413094677,0.694605233,-2.142245073,-0.829531315,-0.401606426,0.392772977,-0.716075904,-2.385008518,-0.637145588,-0.58702671,-2.491004705,-0.7928118390000001,-1.253761284,-1.7182130580000001,-0.485672657,-0.980872977,-0.980392157,0.0,-1.212415131,-0.48402710600000004,-0.955566173,-1.177578898,-0.463070155,3,3,0,29,29,0,-26,-26,0,8,8,0,16,16,0,-8,-8,0,23,23,0,9,8,1,14,15,-1,17,17,0,15,14,1,2,3,-1,18,16,2,21,21,0,-3,-5,2,14,13,1,15,14,1,-1,-1,0,38,35,3,14,14,0,24,21,3,12,11,1,18,18,0,-6,-7,1,15,15,0,19,19,0,-4,-4,0,9.0,5.0,7.0,4.0,4.0,1.0,1.0,5.0,6.0,10.0,4.0,7.0,11.0,8.0,10.0,11.0,8.0,12.0,14.0,18.0,15.0,15.0,9.0,30.0,20.0,25.0,16.0,10.0,25.0,31.0,34.0,33.0,21.0,39.0,31.0,16.0,38.0,14.0,21.0,31.0,19.0,33.0,17.0,23.0,36.0,18.0,26.0,31.0,14.0,28.0,19.0,12.0,11.0,12.0,6.0,8.0,8.0,1.0,2.0,1.0,1.0,0.0,1.0,5.0,1.0,5.0,0.0,2.0,1.0,0.0,3.0,2.0,5.0,0.0,5.0,7.0,5.0,4.0,5.0,6.0,6.0,7.0,10.0,10.0,11.0,6.0,17.0,13.0,14.0,14.0,7.0,19.0,19.0,20.0,21.0,14.0,23.0,20.0,12.0,24.0,11.0,8.0,16.0,8.0,19.0,11.0,8.0,22.0,10.0,13.0,19.0,4.0,18.0,5.0,6.0,4.0,3.0,1.0,3.0,1.0,0.0,0.0,1.0,1.0,0.0,0.0,4.0,4.0,2.0,4.0,2.0,0.0,1.0,2.0,4.0,5.0,4.0,2.0,4.0,3.0,6.0,6.0,2.0,6.0,7.0,8.0,5.0,4.0,3.0,13.0,7.0,11.0,2.0,3.0,6.0,12.0,14.0,12.0,7.0,16.0,11.0,4.0,14.0,3.0,13.0,15.0,11.0,14.0,6.0,15.0,14.0,8.0,13.0,12.0,10.0,10.0,14.0,6.0,7.0,9.0,5.0,5.0,7.0,1.0,2.0,0.0,0.0,0.0,1.0,4.191616766,4.575163399,4.430379747,71,6,63,8,51,9,70,8,63,6,51,5,14,14,141,117,100,42.21556886,38.23529412,31.64556962,127.2108844,128.35820900000002,125.7142857,179,175,202,53.59281437,57.18954248,63.92405063,92.77094972,80.85714286,63.5049505,78.77094972,66.85714286,49.5049505,1007.142857,835.7142857000001,714.2857142999999,245,73.35329341,25.16339869,77,18.67088608,59,300.0,350.0,380.0,38.095238099999996,56,12.5,53.73134328,72,6.944444444,34.28571429,48,18.75,3.571428571,5.555555556,8.333333332999999,51052.93226,88872513.84,316.0,325.0,337.0,316.0,323.0,331.0,331.0,321.0,327.0,357.0,380.0,306.0,310.0,315.0,324.0,291.0,315.0,335.0,334.0,334.0,323.0,312.0,297.0,306.0,312.5,319.0,359.0,560.0,1007.0,1390.0,2085.0,2199.0,2381.0,2447.0,2539.0,2631.0,88.87251282,29.60420401,28.56901329,27.53382258,26.79118576,24.74330848,23.46057216,15.64038144,11.33083749,6.301160867999999,4.039494199,3.58941128,3.5162728060000004,3.4431343310000004,3.341865675,3.5106467689999996,3.634419572,3.758192375,3.758192375,3.7694444480000002,3.5444029880000003,3.2743532369999997,3.645671645,3.5444029880000003,3.4881426230000003,3.4431343310000004,4.2757877319999995,4.016990053,3.6794278639999995,3.6119154260000004,3.7244361560000003,3.7244361560000003,3.634419572,3.5556550610000004,3.791948594,3.6569237180000003,3.5556550610000004,0,0,0,0,0,51990.2861,5501.742802000001,8186.663543000001,8636.859948000001,6189.523322999999,8,58,0.000613057,0,0.0,0.0,0.63,0.09
39094,2472,Cantabria,Cantabria,Valderredible,680,1281,601,908.643266,120.34190100000001,0.0,44.866496999999995,44.866496999999995,9.300841,6.193033,15305.704090000001,34195.219260000005,18889.51517,24056.44907,4195.365309000001,253.27272000000002,13862.12905,13608.85633,8072.560186,2940.3341379999997,1714.3599940000001,26938.565239999996,25224.20525,14883.89361,6033.461711,1462.098728,23981.13081,22519.03208,13970.822040000001,5029.685904,7.0,3.0,4.0,10.0,7.0,9.0,3,4,5,8,3,2,6,3,1,3,1,4,5,1,4,16.0,18.0,11.0,18.0,18.0,18.0,19,22,11,17,21,17,23,14,14,16,18,8,20,16,20,-9,-15,-7,-8,-11,-9,-16,-18,-6,-9,-18,-15,-17,-11,-13,-13,-17,-4,-15,-15,-16,7.592190889,3.32594235,4.519774011,12.12121212,8.631319359,11.18012422,3.75,5.037783375,6.353240152000001,9.937888199,3.807106599,2.597402597,7.9155672820000005,4.059539919,1.360544218,4.120879121000001,1.455604076,5.822416303,7.352941176,1.474926254,10.41666667,17.35357918,19.9556541,12.42937853,21.81818182,22.19482121,22.36024845,23.75,27.70780856,13.97712834,21.11801242,26.64974619,22.07792208,30.34300792,18.94451962,19.04761905,21.97802198,25.35211268,11.64483261,29.41176471,23.59882006,29.76190476,-9.761388286,-16.62971175,-7.90960452,-9.696969697,-13.56350185,-11.18012422,-20.0,-22.67002519,-7.623888182999999,-11.18012422,-22.84263959,-19.48051948,-22.42744063,-14.884979699999999,-17.68707483,-17.85714286,-23.94366197,-5.822416303,-22.05882353,-22.12389381,-23.80952381,33,33,0,57,55,2,-24,-22,-2,45,42,3,42,42,0,3,0,3,60,60,0,60,60,0,0,0,0,54,53,1,51,50,1,3,3,0,45,43,2,41,41,0,4,2,2,51,46,5,58,57,1,-7,-11,4,84,80,4,47,47,0,37,33,4,69,67,2,75,74,1,-6,-7,1,63,59,4,28,28,0,35,31,4,15.0,31.0,18.0,25.0,35.0,17.0,29.0,25.0,32.0,32.0,32.0,34.0,35.0,47.0,53.0,38.0,48.0,72.0,44.0,71.0,71.0,44.0,77.0,86.0,64.0,92.0,72.0,73.0,83.0,75.0,78.0,77.0,67.0,89.0,73.0,68.0,89.0,72.0,59.0,81.0,52.0,96.0,65.0,77.0,97.0,56.0,76.0,97.0,32.0,65.0,63.0,43.0,41.0,41.0,22.0,16.0,29.0,7.0,6.0,10.0,0.0,2.0,3.0,10.0,17.0,9.0,12.0,22.0,11.0,16.0,15.0,16.0,20.0,20.0,20.0,22.0,28.0,30.0,24.0,32.0,45.0,25.0,41.0,36.0,29.0,44.0,52.0,35.0,53.0,51.0,39.0,61.0,46.0,40.0,50.0,40.0,66.0,40.0,37.0,52.0,42.0,29.0,43.0,28.0,43.0,41.0,38.0,49.0,31.0,34.0,53.0,17.0,32.0,27.0,16.0,22.0,14.0,5.0,5.0,9.0,4.0,1.0,5.0,0.0,1.0,0.0,5.0,14.0,9.0,13.0,13.0,6.0,13.0,10.0,16.0,12.0,12.0,14.0,13.0,19.0,23.0,14.0,16.0,27.0,19.0,30.0,35.0,15.0,33.0,34.0,29.0,39.0,21.0,34.0,22.0,29.0,38.0,27.0,27.0,23.0,33.0,31.0,37.0,30.0,30.0,38.0,24.0,53.0,24.0,39.0,48.0,25.0,42.0,44.0,15.0,33.0,36.0,27.0,19.0,27.0,17.0,11.0,20.0,3.0,5.0,5.0,0.0,1.0,3.0,5.7758620689999995,8.287795993,7.180020812,236,31,174,37,149,31,200,36,174,54,149,38,91,69,436,335,306,37.58620689999999,30.51001821,31.84183143,115.61338290000002,132.6271186,132.12560390000002,657,672,586,56.63793103,61.20218579,60.97814776,133.3622527,140.8511905,121.21843,66.36225266,49.85119048,52.21843003,650.7462687000001,368.1318681,443.4782609,136,11.72413793,29.41712204,323,23.41311134,225,173.5294118,225.0,278.125,43.49442379,234,7.692307692000001,77.75423729,367,8.446866485,37.43961353,155,9.677419355,3.8461538460000004,3.814713896,3.225806452,163568.5784,298145669.0,961.0,950.0,989.0,974.0,987.0,1001.0,1001.0,1010.0,1008.0,1086.0,1107.0,1098.0,1099.0,1131.0,1137.0,1127.0,1148.0,1213.0,1160.0,1126.0,1194.0,1261.0,1236.0,1159.0,1162.0,1165.0,1253.0,1562.0,2582.0,4989.0,6092.0,6581.0,7050.0,7554.0,7149.0,7442.0,298.1456604,24.96095362,23.9782125,25.33660892,23.64616004,22.07310343,20.43296552,16.73343155,8.660196484,5.239049926,4.202643763,3.90748602,3.8974238239999996,3.887361629,4.1456246530000005,4.229476285,4.004753913,3.776677475,3.890715694,4.0684811519999995,3.8504669110000003,3.780031541,3.813572193,3.7934478019999998,3.6861177130000002,3.6827636480000003,3.712950236,3.642514865,3.380897775,3.387605906,3.357419319,3.357419319,3.310462405,3.266859557,3.3171705360000003,3.186361991,3.2232567089999997,0,0,2,1,3,55422.1532,2468.1695170000003,7137.9062189999995,7157.5892189999995,3746.6004350000003,24,111,0.03067644,0,0.0,0.0,1.0,0.99
39095,2473,Cantabria,Cantabria,Val de San Vicente,-9,407,416,98.258387,72.505346,0.0,38.010422,38.010422,9.138384,6.826741999999999,30468.82035,39867.04447,9398.224124,34976.316419999996,2323.9051219999997,10.535554,4624.24766,4613.712106,1873.618561,1063.182761,17.315663,4568.97315,4551.6574869999995,1989.64416,1038.070567,42.251126,4692.130311,4649.879185,2371.435333,1005.1803,20.0,19.0,13.0,23.0,23.0,25.0,30,30,25,27,29,29,25,23,35,29,24,21,15,19,20,28.0,43.0,30.0,23.0,19.0,35.0,22,33,25,34,25,31,28,27,31,35,20,32,33,41,24,-8,-24,-17,0,4,-10,8,-3,0,-7,4,-2,-3,-4,4,-6,4,-11,-18,-22,-4,11.70960187,10.98265896,7.692307692,13.51351351,12.70718232,13.27668614,15.83113456,15.56016598,12.48127808,13.10679612,14.12566975,13.97590361,12.13592233,11.3805047,17.36111111,14.42068623,12.07851032,10.56869653,7.606490872,9.743589744,10.03009027,16.39344262,24.85549133,17.75147929,13.51351351,10.49723757,18.58736059,11.60949868,17.11618257,12.48127808,16.50485437,12.17730151,14.93975904,13.59223301,13.35972291,15.37698413,17.40427648,10.0050025,16.10468042,16.73427992,21.02564103,12.03610832,-4.683840749,-13.87283237,-10.0591716,0,2.209944751,-5.310674456,4.2216358839999995,-1.556016598,0.0,-3.398058252,1.948368242,-0.9638554220000001,-1.45631068,-1.9792182090000001,1.984126984,-2.9835902539999997,2.0010005,-5.535983895,-9.127789047,-11.28205128,-2.006018054,105,102,3,113,107,6,-8,-5,-3,136,132,4,155,121,34,-19,11,-30,124,119,5,149,147,2,-25,-28,3,119,109,10,142,139,3,-23,-30,7,140,133,7,102,96,6,38,37,1,110,94,16,123,120,3,-13,-26,13,100,96,4,131,129,2,-31,-33,2,142,133,9,93,88,5,49,45,4,115,109,6,86,83,3,29,26,3,111.0,152.0,98.0,145.0,111.0,124.0,130.0,96.0,104.0,99.0,112.0,142.0,100.0,157.0,199.0,119.0,232.0,214.0,137.0,233.0,208.0,221.0,211.0,207.0,235.0,221.0,203.0,209.0,215.0,182.0,210.0,200.0,151.0,207.0,169.0,134.0,216.0,160.0,94.0,182.0,104.0,135.0,165.0,113.0,141.0,104.0,126.0,118.0,77.0,98.0,94.0,64.0,66.0,36.0,39.0,30.0,28.0,13.0,4.0,3.0,3.0,4.0,0.0,52.0,82.0,50.0,84.0,56.0,68.0,62.0,46.0,61.0,42.0,58.0,72.0,51.0,87.0,115.0,66.0,120.0,102.0,76.0,118.0,96.0,107.0,102.0,115.0,122.0,123.0,108.0,98.0,115.0,109.0,112.0,113.0,87.0,114.0,103.0,77.0,119.0,92.0,49.0,106.0,49.0,72.0,94.0,51.0,57.0,52.0,65.0,54.0,38.0,33.0,25.0,23.0,24.0,10.0,5.0,7.0,11.0,5.0,0.0,0.0,0.0,0.0,0.0,59.0,70.0,48.0,61.0,55.0,56.0,68.0,50.0,43.0,57.0,54.0,70.0,49.0,70.0,84.0,53.0,112.0,112.0,61.0,115.0,112.0,114.0,109.0,92.0,113.0,98.0,95.0,111.0,100.0,73.0,98.0,87.0,64.0,93.0,66.0,57.0,97.0,68.0,45.0,76.0,55.0,63.0,71.0,62.0,84.0,52.0,61.0,64.0,39.0,65.0,69.0,41.0,42.0,26.0,34.0,23.0,17.0,8.0,4.0,3.0,3.0,4.0,0.0,12.4665392,12.75764037,13.85498923,326,147,316,175,324,188,229,179,316,184,324,198,359,386,555,545,647,21.22370937,19.36744847,23.22325915,104.7768207,105.40145990000002,105.1546392,1734,1910,1753,66.30975143,67.87491116,62.92175162,358.0069204,387.5340314,422.9081574,32.00692042,28.53403141,36.90815744,170.2453988,151.810585,167.6165803,411,15.71701721,31.27221038,880,28.786791100000002,802,66.1971831,142.8571429,218.1818182,47.61158966,608,16.11842105,85.10948905,1166,13.03602058,34.16789396,464,23.92241379,7.894736842,6.003430532,12.71551724,34096.115639999996,51256540.08,2786.0,2758.0,2728.0,2772.0,2804.0,2763.0,2797.0,2823.0,2825.0,2844.0,2846.0,2814.0,2784.0,2758.0,2722.0,2670.0,2650.0,2601.0,2615.0,2610.0,2595.0,2560.0,2556.0,2551.0,2543.5,2536.0,2487.0,2408.0,2777.0,3081.0,3026.0,2892.0,2641.0,2575.0,2749.0,2570.0,51.25653839,50.13994469,53.63218208,50.23749322,51.52513382,56.42207006,59.03637068,60.10940451,54.17845386,46.9793723,48.52063908,49.47661468,49.62293748,49.76926028,49.86680881,49.94484763,50.62768734,50.92033294,51.01788147,50.74474558,51.70072118,52.0909153,53.10542002,53.80776944,54.3150218,54.90031298,55.52462358,55.48560416,55.11491975,55.07590034,54.56864798,53.90531797,54.70521592,54.08090532,53.22247826,53.80776944,54.35404121,0,0,12,0,1,32545.71882,2468.172609,2703.8076929999997,4556.771011,3073.4338789999997,107,633,0.003329657,0,1.0,0.0,1.0,1.0
39097,2474,Cantabria,Cantabria,Vega de Pas,247,1682,1435,716.3205,251.176248,0.122584,62.624386,62.501801,22.598704,8.880146,21376.29175,33731.989310000004,12355.697559999999,28410.473830000003,2726.459185,2558.984509,17831.08929,15272.104780000001,10865.87997,3745.141257,12734.52434,26315.743130000003,13581.21879,20661.15312,3173.54601,7382.73715,17813.3077,10430.57055,12877.10164,2540.7605329999997,6.0,10.0,10.0,9.0,7.0,6.0,4,3,5,1,7,7,4,8,4,2,7,3,8,7,5,20.0,15.0,11.0,18.0,10.0,17.0,10,17,14,16,20,20,11,13,14,12,22,12,26,13,20,-14,-5,-1,-9,-3,-11,-6,-14,-9,-15,-13,-13,-7,-5,-10,-10,-15,-9,-18,-6,-15,8.8365243,13.9275766,13.75515818,12.71186441,9.929078014,8.571428571,5.83090379,4.360465116,7.299270073,1.430615165,10.14492754,10.01430615,5.657708628,12.30769231,6.369426752000001,3.215434084,11.76470588,5.0420168069999995,13.51351351,11.36363636,9.933774834,29.455081,20.8913649,15.130674,25.42372881,14.18439716,24.28571429,14.57725948,24.70930233,20.437956200000002,22.88984263,28.98550725,28.61230329,15.55869873,20.0,22.29299363,19.292604500000003,36.60565724,20.16806723,43.91891892,21.1038961,33.11258278,-20.6185567,-6.963788301,-1.375515818,-12.71186441,-4.255319149,-15.71428571,-8.746355685,-20.34883721,-13.13868613,-21.45922747,-18.84057971,-18.59799714,-9.900990099,-7.692307692000001,-15.92356688,-16.07717042,-24.95840266,-15.12605042,-30.40540541,-9.74025974,-24.83443709,24,24,0,26,26,0,-2,-2,0,26,26,0,26,26,0,0,0,0,56,56,0,30,29,1,26,27,-1,30,28,2,30,30,0,0,-2,2,37,37,0,28,28,0,9,9,0,28,28,0,28,28,0,0,0,0,42,42,0,35,35,0,7,7,0,33,29,4,41,41,0,-8,-12,4,46,42,4,25,25,0,21,17,4,29.0,15.0,32.0,19.0,36.0,32.0,16.0,29.0,53.0,31.0,43.0,62.0,31.0,43.0,71.0,26.0,51.0,62.0,45.0,48.0,75.0,37.0,64.0,66.0,59.0,58.0,69.0,54.0,67.0,59.0,61.0,61.0,62.0,56.0,62.0,57.0,67.0,48.0,54.0,45.0,59.0,63.0,46.0,50.0,56.0,52.0,47.0,46.0,30.0,42.0,27.0,24.0,28.0,19.0,11.0,7.0,1.0,8.0,2.0,1.0,1.0,0.0,2.0,14.0,3.0,13.0,9.0,18.0,16.0,5.0,17.0,28.0,16.0,19.0,26.0,18.0,17.0,37.0,13.0,28.0,38.0,24.0,24.0,42.0,18.0,36.0,42.0,31.0,36.0,45.0,39.0,41.0,34.0,32.0,39.0,30.0,37.0,35.0,28.0,40.0,20.0,35.0,27.0,32.0,31.0,21.0,26.0,29.0,23.0,20.0,22.0,21.0,19.0,12.0,9.0,10.0,4.0,1.0,2.0,0.0,3.0,0.0,0.0,0.0,0.0,0.0,15.0,12.0,19.0,10.0,18.0,16.0,11.0,12.0,25.0,15.0,24.0,36.0,13.0,26.0,34.0,13.0,23.0,24.0,21.0,24.0,33.0,19.0,28.0,24.0,28.0,22.0,24.0,15.0,26.0,25.0,29.0,22.0,32.0,19.0,27.0,29.0,27.0,28.0,19.0,18.0,27.0,32.0,25.0,24.0,27.0,29.0,27.0,24.0,9.0,23.0,15.0,15.0,18.0,15.0,10.0,5.0,1.0,5.0,2.0,1.0,1.0,0.0,2.0,12.07430341,9.302325581,8.556149733,117,60,126,42,112,36,98,57,126,38,112,28,80,64,215,235,217,22.1878225,27.3255814,29.01069519,112.03501090000002,105.74162679999999,115.5619597,637,545,467,65.7378741,63.37209302,62.43315508,150.7519623,123.11926609999999,110.4668094,33.75196232,43.11926606,46.46680942,183.7606838,293.75,339.0625,677,69.86584107,27.55813953,237,26.06951872,195,87.09677419,111.62790700000001,216.12903230000003,50.32822757,230,13.91304348,73.44497608,307,4.885993485,34.58213256,120,24.16666667,8.260869565,3.9087947880000002,12.5,48203.719430000005,87482314.8,748.0,746.0,763.0,775.0,784.0,795.0,814.0,801.0,808.0,824.0,849.0,860.0,881.0,906.0,916.0,909.0,955.0,959.0,969.0,1003.0,1013.0,1004.0,1011.0,1009.0,1010.0,1011.0,1098.0,1343.0,1493.0,1858.0,1897.0,2072.0,2032.0,2059.0,2015.0,2066.0,87.48231506,23.61620173,23.03322676,23.53618555,23.22755175,23.68478702,21.68438271,21.23857832,17.06630647,15.35167421,12.55110818,11.55662146,11.54519058,11.5337597,11.55662146,11.47660529,11.57948323,11.46517441,11.07652443,10.96221561,10.91649209,10.39067152,10.4706877,10.35637888,10.07060683,9.830558318,9.704818618,9.419046574,9.236152466,9.156136294,9.304737757,9.087551003,8.961811304,8.858933367999999,8.721762787000001,8.527437797000001,8.55029956,0,1,2,0,1,33837.99362,5052.512126,4431.9393820000005,9058.263289,4048.5909840000004,10,50,0.18343968800000002,0,0.29,0.0,1.0,1.0
39098,2475,Cantabria,Cantabria,Villacarriedo,150,870,720,429.99678200000005,182.276557,0.0,39.624466,39.624466,12.71304,6.913056,16019.04976,25023.5992,9004.549444,19734.92223,2030.152611,2771.35507,13120.42952,10349.07445,7340.85012,2206.527357,7611.908046,16367.28225,8755.374204000002,11069.32242,1903.356934,11097.364140000001,18649.972380000003,7552.608233,14814.223590000001,1842.082813,6.0,10.0,14.0,13.0,6.0,14.0,10,11,7,11,13,14,15,12,5,9,7,13,13,13,10,15.0,15.0,23.0,16.0,17.0,16.0,24,19,24,29,24,29,28,28,21,26,19,31,27,22,32,-9,-5,-9,-3,-11,-2,-14,-8,-17,-18,-11,-15,-13,-16,-16,-17,-12,-18,-14,-9,-22,5.540166205,9.009009009,12.56732496,11.72227232,5.291005291,12.58992806,9.124087591,10.06404392,6.463527238999999,10.06404392,11.97053407,12.99907149,14.07129456,11.47227533,4.9212598430000005,9.018036072000001,6.993006993,12.98701299,13.01301301,13.0,6.21761658,13.85041551,13.51351351,20.64631957,14.42741208,14.99118166,14.38848921,21.89781022,17.38334858,22.16066482,26.53247941,22.09944751,26.9266481,26.26641651,26.76864245,20.66929134,26.05210421,18.77470356,30.96903097,27.02702703,22.0,33.16062176,-8.310249307,-4.504504505,-8.078994614,-2.705139766,-9.700176367,-1.798561151,-12.77372263,-7.319304666,-15.69713758,-16.468435500000002,-10.12891344,-13.9275766,-12.19512195,-15.29636711,-15.7480315,-17.03406814,-11.85770751,-17.98201798,-14.01401401,-9.0,-22.79792746,45,40,5,66,63,3,-21,-23,2,67,64,3,57,53,4,10,11,-1,60,57,3,72,66,6,-12,-9,-3,53,46,7,64,57,7,-11,-11,0,70,67,3,60,57,3,10,10,0,57,54,3,50,49,1,7,5,2,72,68,4,49,43,6,23,25,-2,68,66,2,58,55,3,10,11,-1,69,60,9,41,40,1,28,20,8,52.0,59.0,60.0,63.0,54.0,46.0,65.0,60.0,97.0,63.0,87.0,96.0,60.0,108.0,118.0,81.0,111.0,122.0,109.0,122.0,121.0,89.0,118.0,131.0,121.0,129.0,117.0,118.0,142.0,107.0,140.0,104.0,87.0,138.0,87.0,96.0,125.0,94.0,94.0,85.0,96.0,147.0,89.0,110.0,113.0,73.0,121.0,84.0,68.0,78.0,54.0,62.0,47.0,29.0,21.0,18.0,16.0,3.0,8.0,1.0,0.0,0.0,0.0,25.0,24.0,30.0,34.0,30.0,22.0,31.0,32.0,59.0,32.0,51.0,54.0,30.0,63.0,62.0,52.0,64.0,61.0,67.0,61.0,63.0,43.0,58.0,72.0,64.0,70.0,65.0,58.0,73.0,63.0,72.0,58.0,46.0,73.0,50.0,48.0,68.0,44.0,52.0,47.0,51.0,80.0,45.0,64.0,56.0,33.0,62.0,41.0,37.0,35.0,21.0,24.0,16.0,11.0,9.0,5.0,7.0,0.0,1.0,0.0,0.0,0.0,0.0,27.0,35.0,30.0,29.0,24.0,24.0,34.0,28.0,38.0,31.0,36.0,42.0,30.0,45.0,56.0,29.0,47.0,61.0,42.0,61.0,58.0,46.0,60.0,59.0,57.0,59.0,52.0,60.0,69.0,44.0,68.0,46.0,41.0,65.0,37.0,48.0,57.0,50.0,42.0,38.0,45.0,67.0,44.0,46.0,57.0,40.0,59.0,43.0,31.0,43.0,33.0,38.0,31.0,18.0,12.0,13.0,9.0,3.0,7.0,1.0,0.0,0.0,0.0,11.69354839,9.868796349,11.07692308,228,92,244,87,206,90,216,111,244,86,206,90,173,180,444,478,401,25.57603687,27.26754136,24.67692308,110.93560149999999,108.44233059999999,108.06658130000001,1089,1102,1044,62.73041475,62.86366229,64.24615385,243.7713499,216.37568059999998,218.4099617,40.77134986,43.37568058,38.40996169,218.71921180000004,276.300578,222.7777778,317,18.26036866,29.15002852,511,26.89230769,437,97.91666667,108.04597700000001,198.4126984,45.80801944,377,15.91511936,80.26159334,675,8.740740741,36.87580026,288,18.05555556,7.957559682,5.185185185,9.375,38756.35663,50925126.71,1625.0,1612.0,1612.0,1604.0,1626.0,1636.0,1669.0,1701.0,1716.0,1752.0,1749.0,1753.0,1765.0,1775.0,1764.0,1736.0,1699.0,1724.0,1736.0,1756.0,1750.0,1758.0,1764.0,1760.0,1782.0,1804.0,2115.0,2224.0,2354.0,2485.0,2463.0,2774.0,2613.0,2502.0,2563.0,2417.0,50.92512512,47.46183724,50.32879141,49.1309544,51.31062504,54.47212929,48.36512417,48.79713097,46.22472688,43.67195946,41.53156217,35.42455705,34.99255025,34.56054346,34.63909015,34.52127012,34.36417674,34.48199677,34.08926332,33.85362325,33.36270644,34.08926332,34.63909015,34.85509355,34.65872682,34.42308675,34.34454006,34.40345008,33.69652987,33.40197979,32.77360627,32.12559608,31.92922936,31.49722256,31.65431594,31.65431594,31.90959268,0,1,2,0,2,24542.37417,3364.998813,3360.9122090000005,3363.345133,2203.640557,23,169,0.058896977,0,1.0,1.0,1.0,1.0
39099,2476,Cantabria,Cantabria,Villaescusa,0,437,437,112.66194499999999,80.694858,0.122584,27.935254999999998,27.812671,8.587506,5.689353,917.164994,9891.028941,8973.863947,5513.926289,2394.943012,57.825393000000005,3427.7328420000003,3369.9074490000003,2113.870151,702.344068,357.027199,4532.54657,4175.51937,2522.450183,843.475171,335.250873,5557.621555,5222.370682,2871.086777,1171.836779,46.0,33.0,36.0,29.0,39.0,30.0,32,36,28,36,37,23,28,25,20,29,29,33,16,20,15,26.0,33.0,32.0,28.0,44.0,19.0,29,37,32,23,33,35,25,36,42,34,41,36,34,36,36,20,0,4,1,-5,11,3,-1,-4,13,4,-12,3,-11,-22,-5,-12,-3,-18,-16,-21,28.16901408,19.38895417,20.57142857,16.95906433,22.84710018,17.66784452,19.05896367,20.94240838,15.85503964,19.96672213,20.18548827,12.24707135,14.5152929,12.37623762,10.01502253,14.377788800000001,13.92222756,15.84253481,7.590132827000001,9.337068161,21.47525677,15.92161666,19.38895417,18.28571429,16.37426901,25.77621558,11.18963486,17.27218582,21.52414194,18.1200453,12.75651692,18.00327332,18.63684771,12.96008294,17.82178218,21.03154732,16.856717899999996,19.90291262,17.28276524,16.12903226,16.80672269,16.80672269,12.24739743,0,2.285714286,0.584795322,-2.929115407,6.478209658,1.7867778440000002,-0.581733566,-2.265005663,7.210205214,2.182214948,-6.389776358,1.555209953,-5.445544554,-11.01652479,-2.478929103,-5.825242717999999,-1.4402304369999999,-8.538899431,-7.4696545279999995,-9.803921569,172,169,3,128,125,3,44,44,0,165,164,1,142,127,15,23,37,-14,164,163,1,118,111,7,46,52,-6,185,180,5,125,121,4,60,59,1,168,162,6,158,153,5,10,9,1,172,170,2,141,131,10,31,39,-8,176,162,14,173,167,6,3,-5,8,166,154,12,116,109,7,50,45,5,183,168,15,131,126,5,52,42,10,130.0,170.0,174.0,185.0,194.0,137.0,230.0,163.0,144.0,223.0,141.0,158.0,194.0,166.0,230.0,154.0,210.0,271.0,170.0,273.0,267.0,225.0,310.0,288.0,335.0,327.0,291.0,364.0,312.0,240.0,355.0,266.0,224.0,320.0,228.0,155.0,285.0,184.0,130.0,234.0,151.0,174.0,175.0,146.0,185.0,141.0,156.0,124.0,97.0,114.0,84.0,83.0,64.0,42.0,49.0,19.0,21.0,7.0,5.0,7.0,2.0,2.0,1.0,63.0,93.0,80.0,87.0,93.0,66.0,117.0,80.0,68.0,112.0,65.0,88.0,98.0,90.0,107.0,80.0,104.0,138.0,87.0,138.0,130.0,107.0,167.0,155.0,172.0,172.0,159.0,175.0,168.0,122.0,186.0,137.0,122.0,157.0,124.0,83.0,138.0,98.0,57.0,124.0,71.0,86.0,93.0,66.0,87.0,63.0,72.0,53.0,32.0,48.0,30.0,29.0,21.0,14.0,18.0,7.0,4.0,1.0,0.0,0.0,1.0,0.0,0.0,67.0,77.0,94.0,98.0,101.0,71.0,113.0,83.0,76.0,111.0,76.0,70.0,96.0,76.0,123.0,74.0,106.0,133.0,83.0,135.0,137.0,118.0,143.0,133.0,163.0,155.0,132.0,189.0,144.0,118.0,169.0,129.0,102.0,163.0,104.0,72.0,147.0,86.0,73.0,110.0,80.0,88.0,82.0,80.0,98.0,78.0,84.0,71.0,65.0,66.0,54.0,54.0,43.0,28.0,31.0,12.0,17.0,6.0,5.0,7.0,1.0,2.0,1.0,13.59426352,14.63482366,13.769580599999998,364,241,372,261,427,278,274,214,372,266,427,267,527,545,638,657,788,19.06184643,18.24493196,19.90904497,97.11425206,101.5109121,96.13478692,2254,2417,2625,67.34389005,67.12024438,66.32137443,483.3052351,554.1824576,575.0190476,28.30523514,27.18245759,30.01904762,140.2197802,124.6679317,144.587156,609,18.19539886,33.93501805,1222,27.64022233,1094,82.27848101,130.4964539,127.80269059999999,45.75971731,777,22.39382239,79.85450476,1427,11.91310441,32.5074331,656,19.81707317,12.0978121,5.395935529,10.21341463,25952.95129,28424493.34,3958.0,3933.0,3899.0,3912.0,3883.0,3883.0,3826.0,3808.0,3802.0,3755.0,3687.0,3601.0,3581.0,3543.0,3468.0,3481.0,3437.0,3395.0,3347.0,3303.0,3243.0,3177.0,3113.0,3018.0,3029.5,3041.0,2908.0,3061.0,3266.0,3352.0,2969.0,3302.0,3390.0,3489.0,3209.0,2970.0,28.42449379,104.4873489,112.89559009999998,122.7462493,119.2633376,116.1674162,104.452168,117.9264625,114.9009029,107.6888131,102.30613149999999,106.9851946,106.58061399999998,106.17603329999999,109.5182213,111.76980049999999,114.09174159999999,116.20259709999999,117.7505578,119.43924229999999,120.91684109999998,122.46480190000001,122.00744979999999,124.6460192,125.9828944,126.6865129,129.7120725,132.10437549999997,133.757879,133.9689645,134.60222119999997,136.60753390000002,136.60753390000002,137.6277808,137.17042869999997,138.3665802,139.2461034,0,0,0,0,3,9800.767314,9562.771833,3572.44662,3405.9896700000004,1269.3543300000001,10,64,0.004778175999999999,0,0.98,0.79,1.0,1.0
39101,2477,Cantabria,Cantabria,Villaverde de Truc√≠os,152,735,583,363.969076,136.276553,0.27410500000000004,29.921757,29.647651,10.768345,5.145302,13653.56225,21518.92944,7865.367190000001,17157.62179,2026.530556,11073.86194,14395.168440000001,3321.3065,12678.2504,683.5653440000001,5638.226343,11515.62529,5877.398943,8592.659167,1279.972384,432.84698499999996,4596.783552000001,4163.936565999999,2219.023421,880.927827,1.0,1.0,2.0,1.0,1.0,2.0,3,1,0,0,3,1,2,2,1,2,2,0,2,2,0,4.0,5.0,1.0,2.0,3.0,7.0,3,4,4,6,4,7,4,10,6,10,1,8,5,3,6,-3,-4,1,-1,-2,-5,0,-3,-4,-6,-1,-6,-2,-8,-5,-8,1,-8,-3,-1,-6,10.52631579,10.63829787,23.25581395,12.82051282,12.19512195,25.3164557,37.97468354,13.33333333,0.0,0.0,41.66666667,11.23595506,28.16901408,28.16901408,13.51351351,27.39726027,29.41176471,0.0,29.41176471,25.64102564,12.65822785,42.10526316,53.19148936,11.62790698,25.64102564,36.58536585,88.60759494,37.97468354,53.33333333,57.97101449,93.75,55.55555556,78.65168539,56.33802817,140.84507040000003,81.08108108,136.9863014,14.08450704,117.6470588,73.52941176,38.46153846,75.94936709,-31.57894737,-42.55319149,11.62790698,-12.82051282,-24.3902439,-63.29113924,0.0,-40.0,-57.97101449,-93.75,-13.88888889,-67.41573034,-28.16901408,-112.67605630000001,-67.56756757,-109.58904109999999,14.08450704,-117.6470588,-44.11764706,-12.82051282,-75.94936709,10,10,0,25,25,0,-15,-15,0,16,15,1,22,19,3,-6,-4,-2,27,24,3,14,14,0,13,10,3,24,21,3,25,23,2,-1,-2,1,11,10,1,33,31,2,-22,-21,-1,13,9,4,25,24,1,-12,-15,3,20,15,5,18,18,0,2,-3,5,13,13,0,17,17,0,-4,-4,0,23,23,0,15,14,1,8,9,-1,6.0,10.0,2.0,6.0,6.0,5.0,6.0,4.0,9.0,12.0,8.0,11.0,4.0,14.0,14.0,2.0,19.0,17.0,10.0,22.0,24.0,17.0,31.0,20.0,18.0,25.0,32.0,26.0,33.0,27.0,24.0,28.0,31.0,30.0,30.0,30.0,27.0,27.0,22.0,17.0,29.0,26.0,21.0,15.0,37.0,16.0,23.0,28.0,12.0,24.0,21.0,13.0,18.0,11.0,6.0,8.0,1.0,2.0,1.0,0.0,1.0,0.0,0.0,4.0,3.0,2.0,3.0,4.0,2.0,3.0,2.0,2.0,6.0,1.0,9.0,2.0,9.0,9.0,1.0,13.0,13.0,4.0,11.0,15.0,13.0,23.0,9.0,12.0,12.0,14.0,19.0,16.0,16.0,15.0,16.0,14.0,14.0,17.0,13.0,12.0,11.0,10.0,12.0,12.0,13.0,8.0,10.0,19.0,7.0,8.0,17.0,8.0,12.0,8.0,4.0,10.0,3.0,3.0,2.0,0.0,1.0,0.0,0.0,0.0,0.0,0.0,2.0,7.0,0.0,3.0,2.0,3.0,3.0,2.0,7.0,6.0,7.0,2.0,2.0,5.0,5.0,1.0,6.0,4.0,6.0,11.0,9.0,4.0,8.0,11.0,6.0,13.0,18.0,7.0,17.0,11.0,9.0,12.0,17.0,16.0,13.0,17.0,15.0,16.0,12.0,5.0,17.0,13.0,13.0,5.0,18.0,9.0,15.0,11.0,4.0,12.0,13.0,9.0,8.0,8.0,3.0,6.0,1.0,1.0,1.0,0.0,1.0,0.0,0.0,4.347826087,5.333333333,6.52173913,64,10,64,11,45,8,60,6,64,9,45,10,20,18,124,118,88,33.69565217,31.46666667,31.88405797,104.4444444,104.91803279999999,120.8,228,237,170,61.95652174,63.2,61.5942029,70.38596491,69.78902954,69.76470588,54.38596491,49.78902954,51.76470588,775.0,590.0,488.8888888999999,873,237.2282609,29.6,111,25.72463768,71,200.0,337.5,225.0,38.33333333,69,2.898550725,65.02732239999999,119,8.403361345,30.4,38,15.78947368,0.0,5.882352941000001,5.263157895,21999.010290000002,19628523.8,276.0,274.0,283.0,286.0,306.0,327.0,336.0,327.0,340.0,355.0,369.0,375.0,375.0,390.0,383.0,373.0,388.0,380.0,368.0,366.0,363.0,367.0,371.0,372.0,375.5,379.0,426.0,464.0,565.0,756.0,756.0,757.0,764.0,741.0,738.0,726.0,19.62852287,36.98699106,37.59834628,37.75118509,38.92294927,38.56632539,38.51537912,38.51537912,28.7846418,23.63906867,21.70311046,19.30863583,19.13032389,18.95201195,18.90106568,18.697280600000003,18.49349553,18.64633434,18.74822687,19.3595821,19.76715225,19.00295822,19.5124209,19.86904478,19.10485075,19.10485075,18.79917314,18.08592538,17.32173135,16.65942986,17.11794628,16.65942986,15.58955821,14.57063284,14.41779404,13.95927762,14.06117015,0,0,0,0,1,22527.0631,7025.784393999999,11057.21781,6938.838734999999,2412.441843,0,0,0.000556095,0,0.49,0.0,1.0,1.0
39102,2478,Cantabria,Cantabria,Voto,-3,808,811,217.17319700000002,167.65014,0.0,41.322651,41.322651,12.887623,7.796028999999999,3920.878121,15689.758,11768.87988,10335.19824,2847.47955,357.715762,10308.59247,9950.876705,5363.606629,2267.792523,125.94534099999998,11371.85122,11245.90587,6176.7688689999995,2497.017254,40.760135,9913.952636,9873.1925,4882.602629,2153.5805149999997,11.0,15.0,11.0,13.0,10.0,19.0,14,23,24,16,25,16,24,20,25,27,23,18,20,11,13,29.0,26.0,37.0,30.0,25.0,27.0,27,24,26,22,21,26,26,24,38,27,28,38,32,21,42,-18,-11,-26,-17,-15,-8,-13,-1,-2,-6,4,-10,-2,-4,-13,0,-5,-20,-12,-10,-29,0.927330973,1.198370217,0.821569945,0.913948256,0.673446023,1.206502413,0.844492701,1.300831401,1.267561001,0.7967730690000001,1.175474892,0.7199748009999999,1.033992504,0.845272812,1.041710071,1.108374384,0.92302753,0.7223693720000001,0.79292709,0.430376775,0.42749990299999996,2.444781656,2.077175042,2.763462544,2.109111361,1.683615058,1.714503429,1.628664495,1.357389288,1.373191085,1.09556297,0.987398909,1.169959051,1.1201585459999999,1.014327374,1.5833993080000002,1.108374384,1.139415643,1.5250020069999999,1.268683345,0.821628389,1.6322723559999999,-1.517450683,-0.878804825,-1.941892598,-1.195163105,-1.010169035,-0.508001016,-0.784171794,-0.056557887,-0.10563008300000001,-0.298789901,0.188075983,-0.449984251,-0.086166042,-0.169054562,-0.541689237,0.0,-0.203467079,-0.802632635,-0.475756254,-0.39125161399999997,-1.127045198,134,124,10,130,120,10,4,4,0,120,111,9,163,111,52,-43,0,-43,145,131,14,151,130,21,-6,1,-7,118,111,7,124,114,10,-6,-3,-3,152,127,25,146,133,13,6,-6,12,186,167,19,142,136,6,44,31,13,168,160,8,177,170,7,-9,-10,1,136,120,16,155,153,2,-19,-33,14,271,252,19,147,123,24,124,129,-5,89.0,105.0,78.0,122.0,82.0,52.0,132.0,83.0,96.0,104.0,88.0,113.0,79.0,133.0,135.0,103.0,183.0,165.0,143.0,271.0,172.0,205.0,248.0,138.0,263.0,216.0,193.0,260.0,199.0,142.0,224.0,206.0,142.0,223.0,164.0,128.0,217.0,149.0,149.0,156.0,136.0,154.0,141.0,126.0,153.0,126.0,135.0,109.0,90.0,90.0,75.0,77.0,59.0,46.0,25.0,27.0,26.0,9.0,10.0,2.0,1.0,2.0,0.0,51.0,52.0,36.0,58.0,37.0,25.0,73.0,34.0,52.0,55.0,46.0,58.0,35.0,73.0,77.0,55.0,102.0,88.0,73.0,158.0,96.0,108.0,138.0,68.0,149.0,137.0,104.0,141.0,98.0,82.0,144.0,123.0,71.0,110.0,88.0,66.0,135.0,78.0,80.0,80.0,69.0,78.0,71.0,68.0,74.0,60.0,67.0,60.0,47.0,44.0,26.0,35.0,19.0,19.0,9.0,10.0,10.0,0.0,3.0,0.0,0.0,0.0,0.0,38.0,53.0,42.0,64.0,45.0,27.0,59.0,49.0,44.0,49.0,42.0,55.0,44.0,60.0,58.0,48.0,81.0,77.0,70.0,113.0,76.0,97.0,110.0,70.0,114.0,79.0,89.0,119.0,101.0,60.0,80.0,83.0,71.0,113.0,76.0,62.0,82.0,71.0,69.0,76.0,67.0,76.0,70.0,58.0,79.0,66.0,68.0,49.0,43.0,46.0,49.0,42.0,40.0,27.0,16.0,17.0,16.0,9.0,7.0,2.0,1.0,2.0,0.0,9.964726631,9.955752212,12.29831481,298,113,305,147,323,161,267,113,305,123,323,182,270,343,565,585,625,24.91181658,21.57079646,22.40946576,106.557377,113.8801262,114.5384615,1477,1857,1821,65.12345679,68.47345133,65.29221943,264.253216,301.5024233,377.32180120000004,38.25321598,31.50242326,34.32180121,250.0,216.66666669999998,182.2157434,218,9.611992945,34.43952802,934,31.22983148,871,131.8584071,169.31818180000002,208.65384619999998,44.71766849,491,15.88594705,89.82649842,1139,9.218612817999999,36.53846154,475,18.73684211,8.553971487,4.653204565,8.0,40612.69807,77793552.89,2789.0,2686.0,2724.0,2745.0,2716.0,2725.0,2729.0,2751.0,2795.0,2798.0,2793.0,2712.0,2664.0,2503.0,2386.0,2367.0,2290.0,2279.0,2268.0,2241.0,2221.0,2227.0,2230.0,2230.0,2270.0,2310.0,2546.0,2816.0,3292.0,3698.0,4079.0,3870.0,3598.0,3483.0,3370.0,3151.0,77.79355621,40.50464014,43.31978333,44.7723458,46.25061734,49.74705089,52.43364873,47.53607085,42.3171296,36.19837088,32.7276464,29.69397611,29.17979471,28.665613300000004,28.665613300000004,28.627049699999997,28.54992249,28.80701319,29.15408564,29.29548553,29.43688541,30.42668462,30.67092078,32.17490139,34.24448154,34.86149923,35.90271657,35.96698925,35.92842564,35.3628261,35.08002633,35.02860819,34.91291737,35.28569889,35.01575365,34.52728132,35.85129843,0,1,2,0,1,9344.076767,3885.421461,3146.6070809999997,6154.35904,2932.312878,35,197,0.9125785240000001,0,1.0,0.0,1.0,1.0
